1-Aminopropan-2-Ol	CC(O)CN	fishy
Barium Cyclohexanesulfamate	[Ba++].[O-][S](=O)(=O)NC1CCCCC1.[O-][S](=O)(=O)NC2CCCCC2	sweet
Strontium Bromide (SrBr2)	[Br-].[Br-].[Sr++]	bitter
Conessine Dihydrobromide	[Br-].[Br-].C[C@H]1[C@H]2CC[C@H]3[C@@H]4CC=C5C[C@H](CC[C@]5(C)[C@H]4CC[C@]23CN1C)N(C)C.[H+].[H+]	bitter
Pentamethonium Bromide	[Br-].[Br-].C[N+](C)(C)CCCCC[N+](C)(C)C	bitter
Pancuronium Bromide	[Br-].[Br-].CC(=O)O[C@H]1C[C@@H]2CC[C@@H]3[C@H](CC[C@@]4(C)[C@H]3C[C@@H]([C@@H]4OC(C)=O)[N+]5(C)CCCCC5)[C@@]2(C)C[C@@H]1[N+]6(C)CCCCC6	bitter
Edrophonium Bromide	[Br-].CC[N+](C)(C)c1cccc(O)c1	bitter
Methantheline Bromide	[Br-].CC[N+](C)(CC)CCOC(=O)C1c2ccccc2Oc3ccccc13	bitter
Ethidium Bromide	[Br-].CC[n+]1c2cc(N)ccc2c3ccc(N)cc3c1c4ccccc4	bitter
Domiphen Bromide	[Br-].CCCCCCCCCCCC[N+](C)(C)CCOc1ccccc1	bitter
Neostigmine Bromide	[Br-].CN(C)C(=O)Oc1cccc(c1)[N+](C)(C)C	bitter
Calcium Phosphate	[Ca++].[Ca++].[Ca++].[O-][P]([O-])([O-])=O.[O-][P]([O-])([O-])=O	odorless
Calcium Citrate	[Ca++].[Ca++].[Ca++].OC(CC([O-])=O)(CC([O-])=O)C([O-])=O.OC(CC([O-])=O)(CC([O-])=O)C([O-])=O	odorless
Calcium Pyrophosphate	[Ca++].[Ca++].[O-][P]([O-])(=O)O[P]([O-])([O-])=O	odorless
Calsil	[Ca++].[Ca++].[O-][Si]([O-])([O-])[O-]	odorless
Calcium Iodate	[Ca++].[O-][I](=O)=O.[O-][I](=O)=O	odorless
Calcium Sulfate	[Ca++].[O-][S]([O-])(=O)=O	odorless
Calcium Cyclamate	[Ca++].[O-][S](=O)(=O)NC1CCCCC1.[O-][S](=O)(=O)NC2CCCCC2	sweet
Calcium Carbonate	[Ca++].[O-]C([O-])=O	odorless
Calcium Acetate	[Ca++].CC([O-])=O.CC([O-])=O	"acetic, mild"
Calcium Dl-Pantothenate	[Ca++].CC(C)(CO)C(O)C(=O)NCCC([O-])=O.CC(C)(CO)C(O)C(=O)NCCC([O-])=O	bitter
Calcium Lactate	[Ca++].CC(O)C([O-])=O.CC(O)C([O-])=O	odorless
Calcium Propionate	[Ca++].CCC([O-])=O.CCC([O-])=O	"propionic, acid, bland, mild"
Calcium Lignosulfonate	[Ca++].COc1cccc(CC(C[S]([O-])(=O)=O)Oc2ccc(CCC[S]([O-])(=O)=O)cc2OC)c1O	odorless
Calcium Gluconate	[Ca++].OC[C@@H](O)[C@@H](O)[C@H](O)[C@@H](O)C([O-])=O.OC[C@@H](O)[C@@H](O)[C@H](O)[C@@H](O)C([O-])=O	odorless
Calcium Phenolsulfonate	[Ca++].Oc1ccc(cc1)[S]([O-])(=O)=O.Oc2ccc(cc2)[S]([O-])(=O)=O	bitter
Calcium Saccharin	[CaH2].O=C1N[S](=O)(=O)c2ccccc12	"odorless, sweet"
Allene	[CH2]=[C]=[CH2]	None
Allyl Radical	[CH2]C=C	None
Succinylcholine Chloride	[Cl-].[Cl-].C[N+](C)(C)CCOC(=O)CCC(=O)OCC[N+](C)(C)C	bitter
Quinine Dihydrochloride	[Cl-].[Cl-].COc1ccc2nccc([C@@H](O)[C@@H]3C[C@@H]4CCN3C[C@@H]4C=C)c2c1.[H+].[H+]	bitter
Mibefradil Dihydrochloride	[Cl-].[Cl-].COCC(=O)O[C@]1(CCN(C)CCCc2[nH]c3ccccc3n2)CCc4cc(F)ccc4[C@@H]1C(C)C.[H+].[H+]	bitter
Potassium Chloride	[Cl-].[K+]	bitter
Benzethonium Chloride	[Cl-].CC(C)(C)CC(C)(C)c1ccc(OCCOCC[N+](C)(C)Cc2ccccc2)cc1	bitter
Thiamine	[Cl-].Cc1ncc(C[n+]2csc(CCO)c2C)c(N)n1	bitter
Algaphan	[Cl-].CCC(=O)O[C@@](Cc1ccccc1)([C@H](C)CN(C)C)c2ccccc2.[H+]	bitter
Metalkonium Chloride	[Cl-].CCCCCCCCCCCCNC(=O)C[N+](C)(C)Cc1ccccc1	bitter
Tonedron	[Cl-].CN[C@@H](C)Cc1ccccc1.[H+]	bitter
Chlormerodrin	[Cl-].COC(C[Hg+])CNC(N)=O	bitter
Diltiazem Hydrochloride	[Cl-].COc1ccc(cc1)[C@@H]2Sc3ccccc3N(CCN(C)C)C(=O)[C@@H]2OC(C)=O.[H+]	bitter
Tramadol Hydrochloride	[Cl-].COc1cccc(c1)[C@@]2(O)CCCC[C@@H]2CN(C)C.[H+]	bitter
Ferric-Adenosine Triphosphate Complex	[Fe].Nc1ncnc2n(cnc12)[C@@H]3O[C@H](CO[P](O)(=O)O[P](O)(=O)O[P](O)(O)=O)[C@@H](O)[C@H]3O	sweet-like
Iron(II) Sulfate	[Fe++].[O-][S]([O-])(=O)=O	odorless
Ferroin	[Fe++].c1cnc2c(c1)ccc3cccnc23.c4cnc5c(c4)ccc6cccnc56.c7cnc8c(c7)ccc9cccnc89	bitter
Arecoline Hydrobromide	[H+].[Br-].COC(=O)C1=CCCN(C)C1	bitter
Thiamine Hydrochloride	[H+].[Cl-].[Cl-].Cc1ncc(C[n+]2csc(CCO)c2C)c(N)n1	"mild, sour, bitter"
Naphazoline Hydrochloride	[H+].[Cl-].C1CN=C(Cc2cccc3ccccc23)N1	bitter
Tolazoline Hydrochloride	[H+].[Cl-].C1CN=C(Cc2ccccc2)N1	bitter
Antazoline Hydrochloride	[H+].[Cl-].C1CN=C(CN(Cc2ccccc2)c3ccccc3)N1	bitter
Unacaine	[H+].[Cl-].CC(C)CNCCOC(=O)c1cccc(N)c1	bitter
Fencamine Hydrochloride	[H+].[Cl-].CC(Cc1ccccc1)N(C)CCNc2nc3N(C)C(=O)N(C)C(=O)c3n2C	bitter
Labetalol Hydrochloride	[H+].[Cl-].CC(CCc1ccccc1)NCC(O)c2ccc(O)c(c2)C(N)=O	bitter
Clobutinol Hydrochloride	[H+].[Cl-].CC(CN(C)C)C(C)(O)Cc1ccc(Cl)cc1	bitter
Isoxsuprine Hydrochloride	[H+].[Cl-].CC(COc1ccccc1)NC(C)C(O)c2ccc(O)cc2	bitter
Bupropion Hydrochloride	[H+].[Cl-].CC(NC(C)(C)C)C(=O)c1cccc(Cl)c1	bitter
Methadone Hydrochloride	[H+].[Cl-].CCC(=O)C(CC(C)N(C)C)(c1ccccc1)c2ccccc2	bitter
Largon	[H+].[Cl-].CCC(=O)c1ccc2Sc3ccccc3N(CC(C)N(C)C)c2c1	bitter
Amylocaine Hydrochloride	[H+].[Cl-].CCC(C)(CN(C)C)OC(=O)c1ccccc1	bitter
Inaperisone Hydrochloride	[H+].[Cl-].CCc1ccc(cc1)C(=O)C(C)CN2CCCC2	bitter
Tetracaine Hydrochloride	[H+].[Cl-].CCCCNc1ccc(cc1)C(=O)OCCN(C)C	bitter
Propafenone Hydrochloride	[H+].[Cl-].CCCNCC(O)COc1ccccc1C(=O)CCc2ccccc2	bitter
Dimethocaine Hydrochloride	[H+].[Cl-].CCN(CC)CC(C)(C)COC(=O)c1ccc(N)cc1	bitter
Pethidine Hydrochloride	[H+].[Cl-].CCOC(=O)C1(CCN(C)CC1)c2ccccc2	bitter
Tinoridine Hydrochloride	[H+].[Cl-].CCOC(=O)c1c(N)sc2CN(CCc12)Cc3ccccc3	bitter
Metformin	[H+].[Cl-].CN(C)C(=N)N=C(N)N	bitter
Cyclopentamine Hydrochloride	[H+].[Cl-].CNC(C)CC1CCCC1	bitter
Cyclexedrine Hydrochloride	[H+].[Cl-].CNCC(C)C1CCCCC1	bitter
Phenazopyridine Hydrochloride	[H+].[Cl-].Nc1ccc(N=Nc2ccccc2)c(N)n1	bitter
3184-13-2	[H+].[Cl-].NCCCC(N)C(O)=O	None
Diperodon Hydrochloride	[H+].[Cl-].O=C(Nc1ccccc1)OCC(CN2CCCCC2)OC(=O)Nc3ccccc3	bitter
Pipradrol Hydrochloride	[H+].[Cl-].OC(C1CCCCN1)(c2ccccc2)c3ccccc3	bitter
1798-50-1	[H+].[Cl-].OC(C1CCNCC1)(c2ccccc2)c3ccccc3	bitter
Cycrimine Hydrochloride	[H+].[Cl-].OC(CCN1CCCCC1)(C2CCCC2)c3ccccc3	bitter
Gastomax	[H+].[H+].[Cl-].[Cl-].Cc1ccccc1CN2CCN(CCOC(c3ccccc3)c4ccccc4Cl)CC2	bitter
10402-53-6	[H+].[H+].[Cl-].[Cl-].CCOC(CN1CCN(CC1)CC(C)C(=O)c2ccccc2)c3ccccc3	bitter
Hydroxyzine Dihydrochloride	[H+].[H+].[Cl-].[Cl-].OCCOCCN1CCN(CC1)C(c2ccccc2)c3ccc(Cl)cc3	bitter
6398-98-7	[H+].[H+].O.O.[Cl-].[Cl-].CCN(CC)Cc1cc(Nc2ccnc3cc(Cl)ccc23)ccc1O	bitter
Helium	[He]	odorless
((Propylethylene)Bis(P-Phenyleneoxyethylene))Bis(Trimethylammonium Iodide)	[I-].[I-].CCCC(Cc1ccc(OCC[N+](C)(C)C)cc1)c2ccc(OCC[N+](C)(C)C)cc2	odorless
Tridihexethyl Iodide	[I-].CC[N+](CC)(CC)CCC(O)(C1CCCCC1)c2ccccc2	bitter
Potassium Phosphoric Acid	[K].O[P](O)(O)=O	odorless
Potassium Citrate	[K+].[K+].[K+].OC(CC([O-])=O)(CC([O-])=O)C([O-])=O	odorless
Potassium Sulfate	[K+].[K+].[O-][S]([O-])(=O)=O	bitter
Potassium Sulfite	[K+].[K+].[O-][S]([O-])=O	odorless
Potassium Carbonate	[K+].[K+].[O-]C([O-])=O	odorless
Potassium Nitrate	[K+].[O-][N+]([O-])=O	odorless
Lithium Bromide	[Li+].[Br-]	bitter
Magnesium Bromide	[Mg++].[Br-].[Br-]	bitter
Trimagnesium Phosphate	[Mg++].[Mg++].[Mg++].[O-][P]([O-])([O-])=O.[O-][P]([O-])([O-])=O	odorless
Magnesium Dichlorate	[Mg++].[O-][Cl](=O)=O.[O-][Cl](=O)=O	bitter
Magnesium Sulfate	[Mg++].[O-][S]([O-])(=O)=O	bitter
Magnesium Dioxido(Oxo)Silane	[Mg++].[O-][Si]([O-])=O	odorless
Magnesium Carbonate	[Mg++].[O-]C([O-])=O	odorless
MgAdp	[Mg++].Nc1ncnc2n(cnc12)[C@@H]3O[C@H](CO[P]([O-])(=O)O[P](O)([O-])=O)[C@@H](O)[C@H]3O	sweet-like
MgAtp	[Mg++].Nc1ncnc2n(cnc12)[C@@H]3O[C@H](CO[P](O)(=O)O[P]([O-])(=O)O[P](O)([O-])=O)[C@@H](O)[C@H]3O	sweet-like
Magnesium Hydrogen Phosphate	[Mg++].O[P]([O-])([O-])=O	odorless
Cyclamate Magnesium Dihydrate	[Mg++].O[S](=O)(=O)NC1CCCCC1	sweet
Manganese ATP	[Mn++].Nc1ncnc2n(cnc12)C3O[C@H](CO[P](O)(=O)O[P](O)(=O)O[P](O)(O)=O)[C@@H](O)[C@H]3O	sweet-like
Polyphos	[Na+].[Na+].[Na+].[Na+].[Na+].[Na+].[O-][P]1(=O)O[P]([O-])(=O)O[P]([O-])(=O)O[P]([O-])(=O)O[P]([O-])(=O)O[P]([O-])(=O)O1	None
Tetrasodium Pyrophosphate	[Na+].[Na+].[Na+].[Na+].[O-][P]([O-])(=O)O[P]([O-])([O-])=O	odorless
Trisodium Phosphate	[Na+].[Na+].[Na+].[O-][P]([O-])([O-])=O	odorless
Sodium Citrate	[Na+].[Na+].[Na+].OC(CC([O-])=O)(CC([O-])=O)C([O-])=O	odorless
Sodium Carbonate	[Na+].[Na+].[O-]C([O-])=O	odorless
Disodium Succinate	[Na+].[Na+].[O-]C(=O)CCC([O-])=O	odorless
4578-31-8	[Na+].[Na+].Nc1ncnc2n(cnc12)[C@@H]3O[C@H](CO[P]([O-])([O-])=O)[C@@H](O)[C@H]3O	sweet-like
16178-48-6	[Na+].[Na+].Nc1ncnc2n(cnc12)[C@@H]3O[C@H](CO[P]([O-])(=O)O[P](O)([O-])=O)[C@@H](O)[C@H]3O	sweet-like
Disodium 5'-Inosinate	[Na+].[Na+].O[C@H]1[C@@H](O)[C@@H](O[C@@H]1CO[P]([O-])([O-])=O)n2cnc3C(=O)N=CNc23	odorless
Disodium Hydrogen Phosphate	[Na+].[Na+].O[P]([O-])([O-])=O	odorless
Sodium Tartrate	[Na+].[Na+].OC(C(O)C([O-])=O)C([O-])=O	odorless
Bromthalein	[Na+].[Na+].Oc1ccc(cc1[S]([O-])(=O)=O)C2(OC(=O)c3c(Br)c(Br)c(Br)c(Br)c23)c4ccc(O)c(c4)[S]([O-])(=O)=O	bitter
Sodium Nitrate	[Na+].[O-][N+]([O-])=O	odorless
Suosan	[Na+].[O-]C(=O)CCNC(=O)Nc1ccc(cc1)[N+]([O-])=O	sweet
Indole	[nH]1ccc2ccccc12	"burnt, jasmine, mothball, animal, fishy, floral, moth ball, naphthelene, honey, fecal"
Pyrrole	[nH]1cccc1	"ethereal, nutty, sweet, warm"
Pyrazole	[nH]1cccn1	bitter
Ammonium Chloride	[NH4+].[Cl-]	odorless
Diammonium Sulfide	[NH4+].[NH4+].[S--]	"sulfurous, hard yolk, boiled egg"
Ammonium Picrate	[NH4+].[O-]c1c(cc(cc1[N+]([O-])=O)[N+]([O-])=O)[N+]([O-])=O	bitter
Ammonium Isovalerate	[NH4+].CC(C)CC([O-])=O	"cheesy, acid, sharp, fruity, valeric"
Azanium 4-Amino-5-Hydroxy-5-Oxopentanoate	[NH4+].NC(CCC([O-])=O)C(O)=O	odorless
Ammonium Bicarbonate	[NH4+].OC([O-])=O	"ammoniacal, mild"
Nitrous Oxide	[O-][N+]#N	odorless
22952-24-5	[O-][N+](=O)c1ccc2C(=O)N[S](=O)(=O)c2c1	bitter
1-Nitronaphthalene	[O-][N+](=O)c1cccc2ccccc12	bitter
(2-Nitroethyl)Benzene	[O-][N+](=O)CCc1ccccc1	"spice, flower"
Magnesium Hydroxide	[OH-].[OH-].[Mg++]	odorless
Tetraethylammonium Hydroxide	[OH-].CC[N+](CC)(CC)CC	bitter
Lead Diacetate	[Pb++].CC([O-])=O.CC([O-])=O	sweet
(1-Bromovinyl)Benzene	BrC(=C)c1ccccc1	None
N-Bromosaccharin	BrN1C(=O)c2ccccc2[S]1(=O)=O	sweet
Hydrogen Cyanide	C#N	bitter
1-Furfurylpyrrole	C(n1cccc1)c2occc2	"vegetable, waxy, plastic, coffee, fruity, green"
Benzyl Ether	C(OCc1ccccc1)c2ccccc2	"chocolate, rose, earthy, mushroom, sweet, fruity, cherry, almond, plastic"
Difurfuryl Sulfide	C(SCc1occc1)c2occc2	"powerful, sulfury, earthy, coffee, mushroom, meaty"
Dibenzyl Disulfide	C(SSCc1ccccc1)c2ccccc2	"caramel, burnt, smoky, earthy, green"
Difurfuryl Disulfide	C(SSCc1occc1)c2occc2	"roasted, cabbage, onion, sulfury, coffee, chicken, meaty"
Tiglic Acid	C/C=C(C)/C(O)=O	"caramel, sweet, woody, spicy, dry"
19342-01-9	C[C@@H]([NH+](C)C)c1ccccc1	None
Lilac Aldehyde	C[C@@H](C=O)[C@@H]1CC[C@](C)(O1)C=C	"floral, lilac"
Zingiberene	C[C@@H](CCC=C(C)C)[C@H]1CC=C(C)C=C1	None
D-Alanine	C[C@@H](N)C(O)=O	sweet
6-Deoxyallitol	C[C@@H](O)[C@@H](O)[C@@H](O)[C@@H](O)CO	sweet
6-Deoxyaltrose	C[C@@H](O)[C@@H](O)[C@@H](O)[C@H](O)C=O	sweet
6-Deoxyglucitol	C[C@@H](O)[C@@H](O)[C@H](O)[C@@H](O)CO	sweet
5158-61-2	C[C@@H](O)[C@H](O)[C@@H](O)[C@@H](O)C=O	sweet
D-Lactic Acid	C[C@@H](O)C(O)=O	"acidic, odorless"
Isopinocamphone	C[C@@H]1[C@@H]2C[C@H](CC1=O)C2(C)C	"camphoreous, cedar"
Dexamethasone	C[C@@H]1C[C@H]2[C@@H]3CCC4=CC(=O)C=C[C@]4(C)[C@@]3(F)[C@@H](O)C[C@]2(C)[C@@]1(O)C(=O)CO	bitter
Helenalin	C[C@@H]1C[C@H]2OC(=O)C(=C)[C@H]2[C@H](O)[C@@]3(C)[C@H]1C=CC3=O	bitter
"Cis,Cis-Photocitral A"	C[C@@H]1CC[C@@H]([C@@H]1C=O)C(C)=C	"minty, camphor"
Isopulegol Acetate	C[C@@H]1CC[C@H]([C@@H](C1)OC(C)=O)C(C)=C	"mint, peppermint, sweet, woody, tropical, leaf"
"Cis-1,4-Dimethylcyclohexane"	C[C@@H]1CC[C@H](C)CC1	None
D-Dihydrocarvone	C[C@@H]1CC[C@H](CC1=O)C(C)=C	"minty, herbal"
"(1aR,4S,4aS,7R,7aS)-1,1,4,7-Tetramethyl-2,3,4a,5,6,7,7a,7b-Octahydro-1aH-Cyclopropa[E]Azulen-4-Ol"	C[C@@H]1CC[C@H]2[C@@H]1C3[C@@H](CC[C@]2(C)O)C3(C)C	"herbal, sweet, fruity, tropical, minty, green"
Cedrol	C[C@@H]1CC[C@H]2C(C)(C)[C@H]3C[C@@]12CC[C@@]3(C)O	"soft, cedarwood, sweet, woody, dry"
Pulegone	C[C@@H]1CCC(=C(C)C)C(=O)C1	"lime, herbal, buchu, fresh, peppermint, minty, camphor"
23747-48-0	C[C@@H]1CCC2=C1N=CC[NH2+]2	"roast, nut, roasted, potato, earthy, baked, peanut"
"(4R,4aR)-1,1,4,7-Tetramethyl-1a,2,3,4,4a,5,6,7b-Octahydrocyclopropa[E]Azulene"	C[C@@H]1CCC2C(C3=C(C)CC[C@H]13)C2(C)C	"balsam, wood, balsamic"
Anethofuran	C[C@@H]1CO[C@H]2C=C(C)CC[C@@H]12	dill
EINECS 247-510-1	C[C@@H]1O[C@@H](CO[C@H]2O[C@@H](O)[C@H](O)[C@@H](O)[C@@H]2O)[C@H](O)[C@H](O)[C@H]1O	sweet
Soyasaponin I	C[C@@H]1O[C@@H](O[C@@H]2[C@@H](O)[C@@H](O)[C@@H](CO)O[C@H]2O[C@@H]3[C@@H](O)[C@H](O)[C@H](O[C@H]3O[C@H]4CC[C@@]5(C)[C@@H](CC[C@]6(C)[C@@H]5CC=C7[C@@H]8CC(C)(C)C[C@@H](O)[C@]8(C)CC[C@@]67C)[C@@]4(C)CO)C(O)=O)[C@H](O)[C@H](O)[C@H]1O	sweet-like
Neoeriocitrin Dihydrochalcone	C[C@@H]1O[C@@H](O[C@@H]2[C@@H](O)[C@H](O)[C@@H](CO)O[C@H]2Oc3cc(O)c(C(=O)CCc4ccc(O)c(O)c4)c(O)c3)[C@H](O)[C@H](O)[C@H]1O	sweet-like
Neoeriocitrin	C[C@@H]1O[C@@H](O[C@@H]2[C@@H](O)[C@H](O)[C@@H](CO)O[C@H]2Oc3cc(O)c4C(=O)C[C@H](Oc4c3)c5ccc(O)c(O)c5)[C@H](O)[C@H](O)[C@H]1O	sweet-like
Wistariasaponin D	C[C@@H]1O[C@@H](O[C@@H]2[C@@H](O)[C@H](O)CO[C@H]2O[C@@H]3[C@@H](O)[C@H](O)[C@H](O[C@H]3O[C@H]4CC[C@@]5(C)[C@@H](CC[C@]6(C)[C@@H]5CC=C7[C@@H]8CC(C)(C)CC(=O)[C@]8(C)CC[C@@]67C)[C@@]4(C)CO)C(O)=O)[C@H](O)[C@H](O)[C@H]1O	sweet-like
"4H-1-Benzopyran-4-One, 3-((6-Deoxy-Alpha-L-Mannopyranosyl)Oxy)-2,3-Dihydro-5,7-Dihydroxy-2-(3,4,5-Trihydroxyphenyl)-, (2R,3R)-"	C[C@@H]1O[C@@H](O[C@@H]2[C@H](Oc3cc(O)cc(O)c3C2=O)c4cc(O)c(O)c(O)c4)[C@H](O)[C@H](O)[C@H]1O	sweet-like
"4H-1-Benzopyran-4-One, 3,5-Bis((6-Deoxy-Alpha-L-Mannopyranosyl)Oxy)-2-(3,4-Dihydroxyphenyl)-2,3-Dihydro-7-Hydroxy-, (2R-Trans)-"	C[C@@H]1O[C@@H](O[C@@H]2[C@H](Oc3cc(O)cc(O[C@@H]4O[C@@H](C)[C@H](O)[C@@H](O)[C@H]4O)c3C2=O)c5ccc(O)c(O)c5)[C@H](O)[C@H](O)[C@H]1O	sweet-like
Eriocitrin	C[C@@H]1O[C@@H](OC[C@H]2O[C@@H](Oc3cc(O)c4C(=O)C[C@H](Oc4c3)c5ccc(O)c(O)c5)[C@H](O)[C@@H](O)[C@@H]2O)[C@H](O)[C@H](O)[C@H]1O	sweet-like
Prednisolone	C[C@]12C[C@H](O)[C@H]3[C@@H](CCC4=CC(=O)C=C[C@]34C)[C@@H]1CC[C@]2(O)C(=O)CO	bitter
Prednisone	C[C@]12CC(=O)[C@H]3[C@@H](CCC4=CC(=O)C=C[C@]34C)[C@@H]1CC[C@]2(O)C(=O)CO	bitter
Androstenol	C[C@]12CC[C@H]3[C@@H](CC[C@H]4C[C@H](O)CC[C@]34C)[C@@H]1CC=C2	"natural, musk, animal"
Hydrocortisone	C[C@]12CCC(=O)C=C1CC[C@H]3[C@@H]4CC[C@](O)(C(=O)CO)[C@@]4(C)C[C@H](O)[C@H]23	bitter
Ursodeoxycholic Acid	C[C@H](CCC(O)=O)[C@H]1CC[C@H]2[C@@H]3[C@@H](O)C[C@@H]4C[C@H](O)CC[C@]4(C)[C@H]3CC[C@]12C	bitter
Chenodeoxycholic Acid	C[C@H](CCC(O)=O)[C@H]1CC[C@H]2[C@@H]3[C@H](O)C[C@@H]4C[C@H](O)CC[C@]4(C)[C@H]3CC[C@]12C	bitter
Dehydrocholic Acid	C[C@H](CCC(O)=O)[C@H]1CC[C@H]2[C@H]3[C@H](CC(=O)[C@]12C)[C@@]4(C)CCC(=O)C[C@H]4CC3=O	bitter
(R)-(+)-Citronellal	C[C@H](CCC=C(C)C)CC=O	"citrus, herbal, fresh"
Rhodinol	C[C@H](CCO)CCCC(C)=C	None
Dextromoramide Tartrate	C[C@H](CN1CCOCC1)C(C(=O)N2CCCC2)(c3ccccc3)c4ccccc4.O[C@H]([C@@H](O)C(O)=O)C(O)=O	bitter
Ala-Phe	C[C@H](N)C(=O)N[C@@H](Cc1ccccc1)C(O)=O	sweet
L-Alanine	C[C@H](N)C(O)=O	odorless
Ditab	C[C@H](N)Cc1ccccc1.C[C@H](N)Cc2ccccc2.O[S](O)(=O)=O	bitter
"L-Phenylalanine, N-(N-Glycyl-L-Alanyl)-"	C[C@H](NC(=O)CN)C(=O)N[C@@H](Cc1ccccc1)C(O)=O	sweet
D-Threonine	C[C@H](O)[C@@H](N)C(O)=O	sweet
L-Fucose	C[C@H](O)[C@@H](O)[C@@H](O)[C@H](O)C=O	sweet
L-Fucitol	C[C@H](O)[C@@H](O)[C@@H](O)[C@H](O)CO	sweet
Fuculose	C[C@H](O)[C@@H](O)[C@@H](O)C(=O)CO	sweet
L-Rhamnose	C[C@H](O)[C@H](O)[C@@H](O)[C@@H](O)C=O	"odorless, sweet"
L-Lactic Acid	C[C@H](O)C(O)=O	"acidic, odorless"
Artemisin	C[C@H]1[C@@H]2[C@@H](O)C[C@@]3(C)C=CC(=O)C(=C3[C@H]2OC1=O)C	bitter
Cycloheximide	C[C@H]1C[C@H](C)C(=O)[C@@H](C1)[C@H](O)CC2CC(=O)NC(=O)C2	bitter
"Azulene, 1,2,3,4,5,6,7,8-Octahydro-1,4-Dimethyl-7-(1-Methylethenyl)-, (1S,4S,7R)-"	C[C@H]1CC[C@H](CC2=C1CC[C@@H]2C)C(C)=C	"peppery, balsamic, sweet, woody, balsam, wood"
Geosmin	C[C@H]1CCC[C@@]2(C)CCCC[C@]12O	None
Levofloxacin	C[C@H]1COc2c(N3CCN(C)CC3)c(F)cc4C(=O)C(=CN1c24)C(O)=O	bitter
6-Deoxysucrose	C[C@H]1O[C@H](O[C@@]2(CO)O[C@H](CO)[C@@H](O)[C@@H]2O)[C@H](O)[C@@H](O)[C@@H]1O	sweet
D-Fucopyranose	C[C@H]1OC(O)[C@H](O)[C@@H](O)[C@H]1O	sweet
3615-37-0	C[C@H]1OC(O)[C@H](O)[C@@H](O)[C@H]1O	sweet
Gamma-Terpineol	C[C](C)=[C]1CC[C](C)(O)CC1	"lilac, terpineol"
Trimethylamine N-Oxide	C[N+](C)(C)[O-]	odorless
Betaine	C[N+](C)(C)CC([O-])=O	bland
Dimethyl Sulfone	C[S](C)(=O)=O	"sulfur, burnt, sulfurous"
Dimethyl Sulfoxide	C[S](C)=O	"fatty, mushroom, cheesy, garlic, bitter, oily"
Divinyl Sulfoxide	C=C[S](=O)C=C	bitter
3-Phenylpent-4-Enal	C=CC(CC=O)c1ccccc1	None
"1,3-Butadiene"	C=CC=C	None
Acrolein	C=CC=O	"cherry, almond"
Styrene	C=Cc1ccccc1	"balsamic, gasoline, floral, sweet, balsam, plastic"
2-Vinylpyrazine	C=Cc1cnccn1	nutty
Phenallymal	C=CCC1(C(=O)NC(=O)NC1=O)c2ccccc2	bitter
Cyclopentobarbital	C=CCC1(C2CCC=C2)C(=O)NC(=O)NC1=O	bitter
Allobarbital	C=CCC1(CC=C)C(=O)NC(=O)NC1=O	bitter
Safrole	C=CCc1ccc2OCOc2c1	"spice, warm, floral, sassafrass, sweet, woody, anise, spicy"
4-Pentenal	C=CCCC=O	roasted
Allyl Undecylenate	C=CCCCCCCCCC(=O)OCC=C	"pineapple, fruity, waxy"
10-Undecenal	C=CCCCCCCCCC=O	"citrus, rose, waxy, mandarin, fatty, aldehydic, soapy"
4-Pentenyl Isothiocyanate	C=CCCCN=C=S	"horseradish, mustard"
3-Butenyl Isothiocyanate	C=CCCN=C=S	"pungent, aromatic"
Allyl Isothiocyanate	C=CCN=C=S	"mustard, pungent, garlic, sulfur, strong, bitter"
Allyl Benzoate	C=CCOC(=O)c1ccccc1	"floral, sweet, cherry, berry"
Allyl 2-Furoate	C=CCOC(=O)c1occc1	"jam, caramel, fruity"
Allyl Phenylacetate	C=CCOC(=O)Cc1ccccc1	"fruity, sweet, rum, honey"
2705-87-5	C=CCOC(=O)CCC1CCCCC1	"pineapple, waxy, sweet, fruity, tropical, candy"
Allyl Cyclohexanebutyrate	C=CCOC(=O)CCCC1CCCCC1	"fatty, pineapple, fruity"
7493-68-7	C=CCOC(=O)CCCCC1CCCCC1	"peach, apple, pineapple, apricot, fruity"
2-Propenyl Cyclohexanehexanoate	C=CCOC(=O)CCCCCC1CCCCC1	"fatty, fruity"
Allyl Phenoxyacetate	C=CCOC(=O)COc1ccccc1	"chamomile, pineapple, fresh, sweet, cocoa, honey"
Probenazole	C=CCOC1=N[S](=O)(=O)c2ccccc12	sweet
Allyl Thiocyanate	C=CCSC#N	None
Diallyl Sulfide	C=CCSCC=C	"sulfurous, garlic, onion, horseradish, metallic"
Diallyl Disulfide	C=CCSSCC=C	"garlic, onion, metallic, alliaceous"
Diallyl Trisulfide	C=CCSSSCC=C	"garlic, onion, metallic, green"
Diallyl Tetrasulfide	C=CCSSSSCC=C	"strong, garlic, onion"
"4,4'-Bipyridine"	c1cc(ccn1)c2ccncc2	bitter
1-Pyrroline	C1CC=NC1	"shrimp, ammoniacal"
"2,3-Dihydrobenzofuran"	C1Cc2ccccc2O1	None
Biphenyl	c1ccc(cc1)c2ccccc2	"geranium, rose, pungent, green"
Dicyclohexyl Disulfide	C1CCC(CC1)SSC2CCCCC2	"berry, onion, egg, musty, coffee, nut skin, clam, crab, alliaceous"
Anthracene	c1ccc2cc3ccccc3cc2c1	None
Naphthalene	c1ccc2ccccc2c1	"dry, pungent, tarry, tar"
Isoquinoline	c1ccc2cnccc2c1	"herbal, benzaldehyde, sweet, anise, balsam"
Quinoline	c1ccc2ncccc2c1	"rubber, tobacco, medical, musty, earthy"
"5,6,7,8-Tetrahydroquinoxaline"	C1CCc2nccnc2C1	"nut, roasted, bean, musty, cheese, cereal, corn, chip"
Quinazoline	c1ccc2ncncc2c1	bitter
Pentylenetetrazol	C1CCn2nnnc2CC1	bitter
Pyrrolidine	C1CCNC1	"alkaline, egg, animal, ammoniacal, amine"
Pyridine	c1ccncc1	"sour, putrid, fishy, rancid, sickening, amine"
Piperidine	C1CCNCC1	"floral, sweet, heavy, bitter, animal"
Tetrahydrofuran	C1CCOC1	None
Tetrahydrothiophene	C1CCSC1	cabbage
Piperazine	C1CNCCN1	ammoniacal
Pyrazine	c1cnccn1	"hazelnut, roasted, barley, sweet corn, pungent"
2-(3-Phenylpropyl)Tetrahydrofuran	C1COC(C1)CCCc2ccccc2	"sweet, fruity, green"
"1,4-Dithiane"	C1CSCCS1	"solvent, sulfurous, garlic, onion, pyridine, fishy"
"1,3-Dithiane"	C1CSCSC1	"roasted, alliaceous"
"1,2-Dithiolane"	C1CSSC1	None
"1,2,3,5,6-Pentathiepane"	C1SSCSSS1	mushroom
Picrotoxinum	CC(=C)[C@@H]1C2OC(=O)C1[C@]3(O)CC4O[C@]45C(=O)O[C@H]2[C@]35C.CC(C)(O)[C@@H]6C7OC(=O)C6[C@]8(O)C[C@H]9O[C@]9%10C(=O)O[C@H]7[C@]8%10C	bitter
Cis-Carvyl Acetate	CC(=C)[C@@H]1CC=C(C)[C@@H](C1)OC(C)=O	None
Carvone	CC(=C)[C@H]1CC=C(C)C(=O)C1	"mint, licorice, fennel, basil, minty"
D-Carvone	CC(=C)[C@H]1CC=C(C)C(=O)C1	"caraway, bread, spice"
Elemol	CC(=C)C1CC(CCC1(C)C=C)C(C)(C)O	"sweet, wood, woody, green"
Carvyl Acetate	CC(=C)C1CC=C(C)C(C1)OC(C)=O	"sweet, fruity, minty, spearmint, green"
Carveol	CC(=C)C1CC=C(C)C(O)C1	"caraway, minty, spearmint, fresh"
4-Isopropenyl-1-Methyl-7-Oxabicyclo[4.1.0]Heptan-2-One	CC(=C)C1CC2OC2(C)C(=O)C1	"minty, spearmint"
Dipentene	CC(=C)C1CCC(=CC1)C	"lemon, citrus, orange, herbal, woody, terpene, citric, camphor"
"1-Cyclohexene-1-Carboxaldehyde, 4-(1-Methylethenyl)-, Oxime"	CC(=C)C1CCC(=CC1)C=NO	sweet-like
Perillaldehyde	CC(=C)C1CCC(=CC1)C=O	"mint, spice, fat, herbal, fresh, oily, fatty, sweet, cherry, grassy, cumin, green"
Perilla Alcohol	CC(=C)C1CCC(=CC1)CO	"fatty, terpineol, linalool, green"
Perillyl Acetate	CC(=C)C1CCC(=CC1)COC(C)=O	"herbal, spicy"
"P-Menth-8-Ene-1,2-Diol"	CC(=C)C1CCC(C)(O)C(O)C1	"cool, minty"
"P-Mentha-2,8-Dien-1-Ol"	CC(=C)C1CCC(C)(O)C=C1	None
1195-32-0	CC(=C)c1ccc(C)cc1	"styrene, citrus, gasoline, clove, guaiacol, pine, spicy, phenolic"
"Limonene 1,2-Epoxide"	CC(=C)C1CCC2(C)OC2C1	fruit
Isopropenylpyrazine	CC(=C)c1cnccn1	"nutty, caramellic, chocolate, roasted"
"4-Penten-2-One, 4-Methyl-"	CC(=C)CC(C)=O	"acrylic, vegetable, pungent"
3-Methyl-3-Buten-1-Ol	CC(=C)CCO	"sweet, fruity"
3-Methyl-3-Butenyl Acetate	CC(=C)CCOC(C)=O	fruity
Isopropenyl Acetate	CC(=C)OC(C)=O	"berry, acetic, ethereal, sweet, fruity, grape skin"
"1-Phenyl-1,2-Propanedione"	CC(=O)C(=O)c1ccccc1	"buttery, pepper, honey, plastic"
"2,3-Butanedione"	CC(=O)C(C)=O	"butter, caramel, oily, creamy, sweet, pungent, strong"
Pyruvic Acid	CC(=O)C(O)=O	"acetic, sour, sharp, caramellic"
Methylglyoxal	CC(=O)C=O	"brown, ethereal, acidic, sweet, rum"
2-Acetylpyrrole	CC(=O)c1[nH]ccc1	"nut, licorice, coumarin, bread, musty, nutty, walnut"
Musk Ketone	CC(=O)c1c(C)c(c(c(c1C)[N+]([O-])=O)C(C)(C)C)[N+]([O-])=O	"powdery, musky, fatty, musk, soapy, dry"
"3-Acetyl-2,5-Dimethylfuran"	CC(=O)c1cc(C)oc1C	"leather, earthy, musty, sweet, cocoa, nutty, corn"
Celestolide	CC(=O)c1cc(cc2c1CCC2(C)C)C(C)(C)C	"ambergris, animal, woody, musk, cedar"
Campholenic Aldehyde	CC(=O)C1CC=C(C)C1(C)C	"leafy, amber, herbal, woody, green"
4-Acetyl-1-Methyl-1-Cyclohexene	CC(=O)C1CCC(=CC1)C	spice
4'-Methylacetophenone	CC(=O)c1ccc(C)cc1	"hawthorne, acetophenone, coumarin, sweet, bitter almond, hawthorn, cherry, mimosa"
"2',4'-Dimethylacetophenone"	CC(=O)c1ccc(C)cc1C	"floral, woody, sweet, minty, mimosa"
4'-Hydroxyacetophenone	CC(=O)c1ccc(O)cc1	"mild, sweet, balsam, hawthorn, mimosa"
2-Acetylnaphthalene	CC(=O)c1ccc2ccccc2c1	"orange, powdery, neroli, sweet, blossom"
Acetophenone	CC(=O)c1ccccc1	"mimosa, hawthorn, sweet, acacia, almond, pungent, hawthorne, chemical, flower, bitter, must"
2'-Methylacetophenone	CC(=O)c1ccccc1C	None
2'-Aminoacetophenone	CC(=O)c1ccccc1N	"foxy, grape, sweet"
2'-Hydroxyacetophenone	CC(=O)c1ccccc1O	"tobacco, hawthorne, herbal, sweet, honey, hawthorn, phenolic"
2-Acetylpyridine	CC(=O)c1ccccn1	"tobacco, oily, fatty, heavy, popcorn, corn, chip"
3-Acetylpyridine	CC(=O)c1cccnc1	"dry, sweet, woody, hawthorn, nutty, popcorn, phenolic"
Acetylpyrazine	CC(=O)c1cnccn1	"tomato, coffee, corn, chocolate, nutty, bread crust, roast, hazelnut, popcorn, bitter, chip"
"1-(3,6-Dimethylpyrazin-2-Yl)Ethanone"	CC(=O)c1nc(C)cnc1C	"hazelnut, popcorn, roasted"
"2-Acetyl-3,5-Dimethylpyrazine"	CC(=O)c1ncc(C)nc1C	"nutty, hazelnut, caramel, roasted"
2-Acetyl-3-Methylpyrazine	CC(=O)c1nccnc1C	"roasted, toasted, vegetable, grain, nutty"
2-Acetyl-5-Methylfuran	CC(=O)c1oc(C)cc1	"coconut, coumarin, milky, musty, hay, strong, nutty"
2-Acetylfuran	CC(=O)c1occc1	"caramel, tobacco, balsamic, potato, coffee, sweet, cocoa, peanut, balsam, almond, beef"
2-Acetylthiophene	CC(=O)c1sccc1	"sulfur, sulfury"
2-Acetyl-3-Methylthiophene	CC(=O)c1sccc1C	"cananga, floral, wintergreen, almond, phenolic"
Benzyl 3-Oxobutanoate	CC(=O)CC(=O)OCc1ccccc1	"benzyl acetate, floral, sweet, fruity, benzyl propionate"
Diacetone Alcohol	CC(=O)CC(C)(C)O	None
19872-52-7	CC(=O)CC(C)(C)S	"box tree, sulfurous, blackcurrant, cat-urine, meaty"
Levulinic Acid	CC(=O)CCC(O)=O	"caramel, acetoin, acidic, sweet, buttery"
Dihydro-Alpha-Ionone	CC(=O)CCC1C(=CCCC1(C)C)C	None
4-(4-Hydroxyphenyl)-2-Butanone	CC(=O)CCc1ccc(O)cc1	"berry, jam, ripe, floral, sweet, raspberry"
4-(3-Oxobutyl)Phenyl Acetate	CC(=O)CCc1ccc(OC(C)=O)cc1	"jam, berry, blueberry, raspberry"
Piperonyl Acetone	CC(=O)CCc1ccc2OCOc2c1	"powdery, heliotrope, cotton, sweet, candy, raspberry"
4-(2-Furyl)Butan-2-One	CC(=O)CCc1occc1	"caramel, spicy"
7-Octen-2-One	CC(=O)CCCCC=C	None
8-Nonen-2-One	CC(=O)CCCCCC=C	"fruity, baked"
10-Undecen-2-One	CC(=O)CCCCCCCC=C	"fatty, citrus"
4-Mercapto-2-Butanone	CC(=O)CCS	"onion, sulfurous"
"2-Butanone, 4,4'-Thiobis-"	CC(=O)CCSCCC(C)=O	None
Hydroxyacetone	CC(=O)CO	"caramellic, sweet, pungent, ethereal"
Acetoxyacetone	CC(=O)COC(C)=O	"buttery, fruity"
Acetaminophen	CC(=O)Nc1ccc(O)cc1	bitter
Alpha-Terpinyl Acetate	CC(=O)OC(C)(C)C1CCC(=CC1)C	"citrus, lime, wax, herbal, sweet, bergamot, lavender, pine"
Dimethylbenzylcarbinyl Acetate	CC(=O)OC(C)(C)Cc1ccccc1	"berry, powdery, rose, jasmin, floral, sweet, fruity, pear, green"
Dmpec Acetate	CC(=O)OC(C)(C)CCc1ccccc1	"leafy, rose, narcissus, sweet, balsam, deep, green"
Myrcenyl Acetate	CC(=O)OC(C)(C)CCCC(=C)C=C	"citrus, floral, woody, nutmeg, bergamot, lavender"
Acetic Anhydride	CC(=O)OC(C)=O	"sharp, vinegar"
3891-59-6	CC(=O)OC[C@@H](OC(C)=O)[C@@H](OC(C)=O)[C@H](OC(C)=O)[C@@H](OC(C)=O)C=O	bitter
Sucrose Octaacetate	CC(=O)OC[C@H]1O[C@H](O[C@]2(COC(C)=O)O[C@H](COC(C)=O)[C@@H](OC(C)=O)[C@@H]2OC(C)=O)[C@H](OC(C)=O)[C@@H](OC(C)=O)[C@@H]1OC(C)=O	bitter
1-Acetylcyclohexyl Acetate	CC(=O)OC1(CCCCC1)C(C)=O	"floral, sweet, fruity, honey, nutty"
Beta-Caryophyllene Alcohol Acetate	CC(=O)OC12CCCC(C)(CCC3C1CC3(C)C)C2	"earthy, woody, dry"
Fenchyl Acetate	CC(=O)OC1C(C)(C)C2CCC1(C)C2	"fir, citrus, herbal, fresh, sweet, pine"
Nomilin	CC(=O)OC1CC(=O)OC(C)(C)C2CC(=O)C3(C)C(CCC4(C)C(OC(=O)C5OC345)c6cocc6)C12C	bitter
Bornyl Acetate	CC(=O)OC1CC2CCC1(C)C2(C)C	"cedar, balsamic, spice, herbal, fresh, sweet, woody, pine needle, pine, camphor"
P-Tolyl Acetate	CC(=O)Oc1ccc(C)cc1	"phenolic, animal, narcissus"
4-Tert-Butylcyclohexyl Acetate	CC(=O)OC1CCC(CC1)C(C)(C)C	creamy
Cyclohexyl Acetate	CC(=O)OC1CCCCC1	"musty, sweet, fruity, ethereal"
Phenyl Acetate	CC(=O)Oc1ccccc1	phenolic
O-Tolyl Acetate	CC(=O)Oc1ccccc1C	"floral, fruit, sweet, medicinal"
13100-46-4	CC(=O)OC1OC(CO)C(OC(C)=O)C(OC(C)=O)C1OC(C)=O	sweet
Limonen-10-Yl Acetate	CC(=O)OCC(=C)C1CCC(=CC1)C	"minty, sweet, fruity, mild"
Triacetin	CC(=O)OCC(COC(C)=O)OC(C)=O	"tropical, mild, bitter, fruity, clean"
Prenyl Acetate	CC(=O)OCC=C(C)C	"jasmin, banana, fresh, ripe, heliotrope, sweet, fruity, balsam, lavender"
Myrtenyl Acetate	CC(=O)OCC1=CCC2CC1C2(C)C	None
4-Methylbenzyl Acetate	CC(=O)OCc1ccc(C)cc1	"herbal, floral, sweet, fruity, green"
Piperonyl Acetate	CC(=O)OCc1ccc2OCOc2c1	"hawthorn, sweet, metallic, strawberry, jam, floral, bitter"
Benzyl Acetate	CC(=O)OCc1ccccc1	"apple, bitter, apricot, plum, jasmine, boiled vegetable, cherry, sweet, floral, fresh, jasmin, fruity"
Tetrahydrofurfuryl Acetate	CC(=O)OCC1CCCO1	"brown, caramel, ether, sweet, rum, fruity, maple"
Furfuryl Acetate	CC(=O)OCc1occc1	"horseradish, sweet, fruity, banana"
.Alpha.-Campholenyl Acetate	CC(=O)OCCC1CC=C(C)C1(C)C	"jammy, ionone, sweet, woody, raspberry"
Phenethyl Acetate	CC(=O)OCCc1ccccc1	"tobacco, rose, floral, sweet, honey, fruity, tropical"
2-Cyclohexylethyl Acetate	CC(=O)OCCC1CCCCC1	"mint, rose, green, plant, raspberry, plastic"
656-53-1	CC(=O)OCCc1scnc1C	"beef juice, meaty, beef gravey"
4-Penten-1-Yl Acetate	CC(=O)OCCCC=C	"vegetable, metallic, meat, green, acrylate, weedy, sulfide, cooked, plastic"
3-Phenylpropyl Acetate	CC(=O)OCCCc1ccccc1	"spicy, sweet, balsam, storax, cinnamon, bitter"
10-Undecen-1-Yl Acetate	CC(=O)OCCCCCCCCCC=C	"laundered cloths, rose, clean, fresh"
55764-22-2	CC(=O)Sc1cc(C)oc1C	"floral, fruity"
S-Furfuryl Thioacetate	CC(=O)SCc1occc1	"roast, burnt, roasted, sulfury, coffee, nutty"
Dimethylmalonic Acid	CC(C)(C(O)=O)C(O)=O	None
"2,4-Di-Tert-Butylphenol"	CC(C)(C)c1ccc(O)c(c1)C(C)(C)C	None
4-Tert-Butylphenol	CC(C)(C)c1ccc(O)cc1	"leather, oakmoss"
Triton X-100	CC(C)(C)CC(C)(C)c1ccc(OCCO)cc1	"alcohol, bland"
Tert-Butanol	CC(C)(C)O	camphor
16669-42-4	CC(C)(c1c(Cl)c(Cl)c(O)c(Cl)c1Cl)c2c(Cl)c(Cl)c(O)c(Cl)c2Cl	"oily, butter, fatty"
Beta-Eudesmol	CC(C)(O)[C@@H]1CC[C@@]2(C)CCCC(=C)[C@@H]2C1	"wood, green"
"2,5-Dimethyl-3-Hexyne-2,5-Diol"	CC(C)(O)C#CC(C)(C)O	None
2-Methyl-3-Buten-2-Ol	CC(C)(O)C=C	"oily, earthy, herbal, herb"
Terpin	CC(C)(O)C1CCC(C)(O)CC1	bitter
2-Methyl-1-Phenyl-2-Propanol	CC(C)(O)Cc1ccccc1	"rhubarb, rose, green, cortex, clean, floral, bitter, oily"
2-Methyl-4-Phenyl-2-Butanol	CC(C)(O)CCc1ccccc1	"rose, linalool, fresh, lily, clean, violet, green"
Myrcenol	CC(C)(O)CCCC(=C)C=C	"floral, citrus, lavender, fresh"
Linamarin	CC(C)(O[C@@H]1O[C@H](CO)[C@@H](O)[C@H](O)[C@H]1O)C#N	bitter
Beta-Bourbonene	CC(C)[C@@H]1CC[C@@]2(C)[C@@H]3CCC(=C)[C@@H]3[C@@H]12	None
Beta-Cubebene	CC(C)[C@@H]1CC[C@@H](C)[C@@]23CCC(=C)[C@@H]2[C@@H]13	"fruity, citrus, fruit"
L-Menthol	CC(C)[C@@H]1CC[C@@H](C)C[C@H]1O	"cooling, tobacco, mentholic, peppermint, camphoraceous, minty"
Beta-Cadinene	CC(C)[C@@H]1CC=C(C)[C@@H]2CC=C(C)C[C@@H]12	None
D-Piperitone	CC(C)[C@@H]1CCC(=CC1=O)C	"minty, peppermint"
N-Valylphenylalanine	CC(C)[C@H](N)C(=O)N[C@@H](Cc1ccccc1)C(O)=O	sweet
L-Valine	CC(C)[C@H](N)C(O)=O	odorless
"(1r,4r)-4-Isopropyl-1-Methylcyclohex-2-En-1-Ol"	CC(C)[C@H]1CC[C@@](C)(O)C=C1	herb
(+)-Isomenthone	CC(C)[C@H]1CC[C@@H](C)CC1=O	minty
"Benzyl 2,3-Dimethylbut-2-Enoate"	CC(C)=C(C)C(=O)OCc1ccccc1	"herbal, fruity, spicy, warm"
Terpinolene	CC(C)=C1CCC(=CC1)C	"citrus, fresh, sweet, woody, pine, plastic"
Piperitenone Oxide	CC(C)=C1CCC2(C)OC2C1=O	"minty, herbal"
Artemisia Ketone	CC(C)=CC(=O)C(C)(C)C=C	"mint, berry, herbal, honey, herb, green"
Phenethyl Senecioate	CC(C)=CC(=O)OCCc1ccccc1	"sweet, herbal, deep, wine"
Mesityl Oxide	CC(C)=CC(C)=O	"acrylic, vegetable, chemical, earthy, sweet, pungent"
"3,3-Dimethylacrylic Acid"	CC(C)=CC(O)=O	"alcohol, dairy, phenolic, green"
"3,3,6-Trimethylhepta-1,5-Dien-4-Ol"	CC(C)=CC(O)C(C)(C)C=C	"herbal, herb"
Alpha-Bisabolene	CC(C)=CC\C=C(/C)C1CCC(=CC1)C	"spicy, balsamic"
3-Methyl-2-Butenal	CC(C)=CC=O	"brown, sweet, pungent, fruity, cherry, nutty, almond"
58461-27-1	CC(C)=CCC(CO)C(C)=C	"herbal, herb"
Hernandulcin	CC(C)=CCC[C@](C)(O)[C@@H]1CCC(=CC1=O)C	sweet
Myrcene	CC(C)=CCCC(=C)C=C	"peppery, spice, balsamic, must, balsam, terpene, spicy, plastic"
P-Camphorene	CC(C)=CCCC(=C)C1CCC(=CC1)CCC=C(C)C	"solvent, low, diterpene"
Linalool	CC(C)=CCCC(C)(O)C=C	"lemon, citrus, orange, floral, sweet, woody, blueberry, bois de rose, lavender, flower, green"
(+)-Linalool	CC(C)=CCCC(C)(O)C=C	"floral, sweet, lavender, petitgrain"
Epoxylinalool	CC(C)=CCCC(C)(O)C1=CO1	"musty, alcohol, fenchyl, camphor"
Bisabolol	CC(C)=CCCC(C)(O)C1CCC(=CC1)C	"peppery, spice, mild, floral, flower"
6-Methyl-2-(Oxiran-2-Yl)Hept-5-En-2-Ol	CC(C)=CCCC(C)(O)C1CO1	"herbal, floral, earthy, wood, flower, green"
Linalyl Benzoate	CC(C)=CCCC(C)(OC(=O)c1ccccc1)C=C	"broom, gardenia, heather, genet, lily, bergamot, tuberose"
Linalyl Anthranilate	CC(C)=CCCC(C)(OC(=O)c1ccccc1N)C=C	"orange, gardenia, herbal, linalool, fresh, woody, blossom"
Linalyl Acetate	CC(C)=CCCC(C)(OC(C)=O)C=C	"citrus, fruit, sweet, woody, bergamot, lavender, green"
Linalyl Formate	CC(C)=CCCC(C)(OC=O)C=C	"coriander, citrus, rose, green, bergamot, herbal, bitter, fruity"
Nerolidyl Acetate	CC(C)=CCCC(C)=CCCC(C)(OC(C)=O)C=C	None
Farnesylacetone	CC(C)=CCCC(C)=CCCC(C)=CCCC(C)=O	"floral, creamy, wine, fruity"
6-Methyl-5-Hepten-2-One	CC(C)=CCCC(C)=O	"pepper, apple, mushroom, citrus, musty, rubber, nutty, green, hazelnut, bitter, lemongrass"
Alpha-Bergamotene	CC(C)=CCCC1(C)C2CC=C(C)C1C2	None
Santalene	CC(C)=CCCC1(C)C2CC3C(C2)C13C	woody
"Bicyclo[2.2.1]Heptane, 2-Methyl-3-Methylene-2-(4-Methyl-3-Pentenyl)-, (1S-Exo)-"	CC(C)=CCCC1(C)C2CCC(C2)C1=C	woody
Nerol Oxide	CC(C)=CCCC1(C)OC1CO	"oil, diphenyl oxide, cortex, herbal, narcissus, celery, weedy, flower, green"
Myrac Aldehyde	CC(C)=CCCC1=CCC(CC1)C=O	"citrus, floral, aldehydic, marine, greasy"
Perillen	CC(C)=CCCc1cocc1	"wood, woody"
Galegine	CC(C)=CCN=C(N)N	bitter
Galegine Sulfate	CC(C)=CCN=C(N)N.O[S](O)(=O)=O	bitter
3-Methyl-2-Buten-1-Ol	CC(C)=CCO	"lavender, fruity, herb, green"
Prenyl Benzoate	CC(C)=CCOC(=O)c1ccccc1	"chocolate, fruity, balsam, tea, ylang"
Prenyl Formate	CC(C)=CCOC=O	"rum, fruity"
Prenylthiol	CC(C)=CCS	"sulfurous, leek, onion, amine, smoke"
Acetone	CC(C)=O	"solvent, apple, pear, ethereal"
Acetyl Isobutyryl	CC(C)C(=O)C(C)=O	"fatty, sweet, creamy, fruity, buttery"
3-Methyl-2-Oxobutanoic Acid	CC(C)C(=O)C(O)=O	fruity
10031-71-7	CC(C)C(=O)OC(C)(C)CCc1ccccc1	"floral, sweet, papaya, fruity, juicy, green"
Linalyl Isobutyrate	CC(C)C(=O)OC(C)(CCC=C(C)C)C=C	"light, woody, fruity, bergamot, lavender"
103-59-3	CC(C)C(=O)OC\C=C\c1ccccc1	None
P-Tolyl Isobutyrate	CC(C)C(=O)Oc1ccc(C)cc1	"animal, narcissus, floral, lily, fruity, green"
O-Tolyl Isobutyrate	CC(C)C(=O)Oc1ccccc1C	"berry, medical, phenolic"
Piperonyl Isobutyrate	CC(C)C(=O)OCc1ccc2OCOc2c1	"berry, powdery, jam, heliotrope, plum, fruity, tropical"
Benzyl Isobutyrate	CC(C)C(=O)OCc1ccccc1	"jasmine, jasmin, rose, oily, sweet, fruity, tropical"
Phenethyl Isobutyrate	CC(C)C(=O)OCCc1ccccc1	"peach, rose, pastry, tea, floral, bitter, fruity"
3-Phenylpropyl Isobutyrate	CC(C)C(=O)OCCCc1ccccc1	"balsam, sweet, bitter, fruity"
Phenoxyethyl Isobutyrate	CC(C)C(=O)OCCOc1ccccc1	"rose, waxy, floral, sweet, tropical, fruity, honey"
3-Methyl-2-Butanone	CC(C)C(C)=O	camphor
3-Methyl-2-Butanol	CC(C)C(C)O	fruity
DL-Valine	CC(C)C(N)C(O)=O	odorless
Isobutyric Acid	CC(C)C(O)=O	"rancid, butter, strawberry, cheese"
L-Leucine	CC(C)C[C@H](N)C(O)=O	"odorless, bitter"
Phenylalanylleucine	CC(C)C[C@H](NC(=O)[C@@H](N)Cc1ccccc1)C(O)=O	bitter
Glycyl-L-Leucine	CC(C)C[C@H](NC(=O)CN)C(O)=O	bitter
Isobutyraldehyde	CC(C)C=O	"malt, fresh, floral, pungent, aldehydic, green"
Narcobarbital	CC(C)C1(CC(Br)=C)C(=O)NC(=O)N(C)C1=O	bitter
Propallylonal	CC(C)C1(CC(Br)=C)C(=O)NC(=O)NC1=O	bitter
Aprobarbital	CC(C)C1(CC=C)C(=O)NC(=O)NC1=O	bitter
Propyphenazone	CC(C)C1=C(C)N(C)N(c2ccccc2)C1=O	bitter
Hinokitiol	CC(C)C1=CC(=O)C(=CC=C1)O	"woody, phenolic"
Thymoquinone	CC(C)C1=CC(=O)C(=CC1=O)C	None
"Cyclohexene, 4-Ethenyl-4-Methyl-3-(1-Methylethenyl)-1-(1-Methylethyl)-, (3R-Trans)-"	CC(C)C1=CC(C(C)=C)C(C)(CC1)C=C	"wood, woody"
Alpha-Terpinene	CC(C)C1=CC=C(C)CC1	"lemon, citrus, terpene, medicinal, herbal, woody, bitter, camphoraceous"
Gamma-Terpinene	CC(C)C1=CCC(=CC1)C	"lemon, gasoline, tropical, terpene, turpentine, herbal, woody, bitter, oily, lime"
1-Terpineol	CC(C)C1=CCC(C)(O)CC1	"must, woody, musty, dry"
56424-87-4	CC(C)C1=CCC(CC1)C(O)=O	None
3-Thujene	CC(C)C12CC=C(C)C1C2	"wood, woody, herb, green"
3-Thujanone	CC(C)C12CC1C(C)C(=O)C2	cedarleaf
Thujyl Alcohol	CC(C)C12CC1C(C)CC2O	"minty, camphoreous"
Sabinene	CC(C)C12CCC(=C)C1C2	"citrus, spice, pepper, turpentine, woody, terpene, wood, pine"
"1,4-Cineole"	CC(C)C12CCC(C)(CC1)O2	"cooling, spice, green, terpene, minty, pine, camphor"
Sabinene Hydrate	CC(C)C12CCC(C)(O)C1C2	"minty, eucalyptus, terpene, green"
Alpha-Phellandrene	CC(C)C1CC=C(C)C=C1	"mint, citrus, peppery, spice, herbal, turpentine, woody, terpene, green"
Diosphenol	CC(C)C1CCC(=C(O)C1=O)C	"leaves, minty, buchu, blackcurrant"
Beta-Phellandrene	CC(C)C1CCC(=C)C=C1	"mint, terpentine"
"7-Methyl-4-Methylidene-1-Propan-2-Yl-2,3,4a,5,6,8a-Hexahydro-1H-Naphthalene"	CC(C)C1CCC(=C)C2CCC(=CC12)C	"spice, herbal, woody, wood, herb"
2-Methyl-3-[4-(Propan-2-Yl)Cyclohex-1-En-1-Yl]Propanal	CC(C)C1CCC(=CC1)CC(C)C=O	"herbal, spicy"
Piperitone	CC(C)C1CCC(=CC1=O)C	"mint, herbal, fresh, fruit, sweet, minty, medicinal, camphor"
Piperitol	CC(C)C1CCC(=CC1O)C	"herbal, herb"
Crypton	CC(C)C1CCC(=O)C=C1	"spice, herbal, caraway, woody, cumin"
Carvomenthone	CC(C)C1CCC(C)C(=O)C1	"minty, spearmint, herbal"
Carvacrol	CC(C)c1ccc(C)c(O)c1	"woody, thymol, spice, camphor"
P-Menthan-2-Ol	CC(C)C1CCC(C)C(O)C1	None
.Alpha.-Cubebene	CC(C)C1CCC(C)C23CC=C(C)C2C13	"wax, herbal, waxy, herb"
483-77-2	CC(C)C1CCC(C)c2ccc(C)cc12	"spice, herb"
Cadalene	CC(C)c1ccc(C)c2ccc(C)cc12	None
Menthone Lactone	CC(C)C1CCC(C)CC(=O)O1	"brown, sugar, maple syrup"
P-Cymene	CC(C)c1ccc(C)cc1	"solvent, citrus, spice, gasoline, fresh, woody, terpene"
2-Isopropyl-5-Methylcyclohexanone	CC(C)C1CCC(C)CC1=O	"mint, fresh, peppermint, sweet, cool, minty, green"
Menthone	CC(C)C1CCC(C)CC1=O	"menthol, camphor, peppermint, deep, herbal, raspberry, bitter, camphoraceous"
Dl-Menthol	CC(C)C1CCC(C)CC1O	"camphoraceous, minty"
Thymol	CC(C)c1ccc(C)cc1O	"herbal, thyme, camphor, medicinal, phenolic"
Neoisomenthol	CC(C)C1CCC(C)CC1O	menthol
Menthol Acetoacetate	CC(C)C1CCC(C)CC1O.CC(=O)CC(O)=O	minty
(-)-Menthyl Lactate	CC(C)C1CCC(C)CC1OC(=O)C(C)O	"camphoraceous, alcohol, mild cooling"
Menthyl Acetate	CC(C)C1CCC(C)CC1OC(C)=O	"camphoraceous, orange, raspberry, melon"
4-Isopropylbenzaldehyde	CC(C)c1ccc(C=O)cc1	"spicy, acid, herbal, sharp, oily, cumin, green"
Cortexal	CC(C)c1ccc(CC=O)cc1	"fern, cortex, earthy, aldehydic, cumin, green"
4'-Isopropylacetophenone	CC(C)c1ccc(cc1)C(C)=O	"woody, herbal, spicy"
7775-00-0	CC(C)c1ccc(CCC=O)cc1	"fresh, floral, muguet, melon, fruity"
4-Isopropylbenzyl Alcohol	CC(C)c1ccc(CO)cc1	"spicy, herb, herbal, leather, caraway, strong, wood, cumin"
4-Isopropylphenol	CC(C)c1ccc(O)cc1	"woody, medicinal, spicy, warm"
Decatone	CC(C)C1CCC2CC(=O)CCC2C1	"gardenia, green, vetiver, woody, rhubarb, grapefruit"
M-Cymene	CC(C)c1cccc(C)c1	None
2-Isopropyltoluene	CC(C)c1ccccc1C	None
2-Isopropylphenol	CC(C)c1ccccc1O	"phenolic, medicinal, creosote"
2-Isopropyl-5-Methylpyrazine	CC(C)c1cnc(C)cn1	"sweat, earthy, coffee, nutty, green"
2-Isopropylpyrazine	CC(C)c1cnccn1	"minty, nutty, honey, green"
"2-Isopropyl-4-Methyl-1,3-Dioxolane"	CC(C)C1OCC(C)O1	winey
2-Isopropyl-4-Methylthiazole	CC(C)c1scc(C)n1	"nut, rooty, vegetable, earthy, fruit, tropical, green"
"5-Methylhexane-2,3-Dione"	CC(C)CC(=O)C(C)=O	"brown, butter, sharp, sweet, creamy, fruity"
4-Methyl-2-Oxovaleric Acid	CC(C)CC(=O)C(O)=O	fruity
61295-51-0	CC(C)CC(=O)C(Sc1ccoc1C)C(C)C	meaty
Humulone	CC(C)CC(=O)C1=C(O)C(=C(O)[C@@](O)(CC=C(C)C)C1=O)CC=C(C)C	bitter
Lupulone	CC(C)CC(=O)C1=C(O)C(=C(O)C(CC=C(C)C)(CC=C(C)C)C1=O)CC=C(C)C	bitter
"5,6-Dihydroxy-4-(3-Methylbutanoyl)-2,6-Bis(3-Methylbut-2-En-1-Yl)Cyclohex-4-Ene-1,3-Dione"	CC(C)CC(=O)C1=C(O)C(O)(CC=C(C)C)C(=O)C(CC=C(C)C)C1=O	bitter
"2,6-Dimethyl-4-Heptanone"	CC(C)CC(=O)CC(C)C	"pineapple, banana, fruity, metallic, green"
Isopropyl Isovalerate	CC(C)CC(=O)OC(C)C	"fruity, apple, pineapple"
Bornyl Isovalerate	CC(C)CC(=O)OC1CC2CCC1(C)C2(C)C	None
P-Tolyl Isovalerate	CC(C)CC(=O)Oc1ccc(C)cc1	"tobacco, herbal, animal, sweet"
Allyl Isovalerate	CC(C)CC(=O)OCC=C	"apple, pineapple, banana, sweet, fruity, cherry"
Benzyl Isovalerate	CC(C)CC(=O)OCc1ccccc1	"apple, pineapple, herbal, sweet, fruity"
Furfuryl Isovalerate	CC(C)CC(=O)OCc1occc1	"berry, grape, ripe, plum, fruity"
Citronellyl Isovalerate	CC(C)CC(=O)OCCC(C)CCC=C(C)C	"chamomile, apple, blackcurrant, rose, herbal, honey"
Phenylethyl Isovalerate	CC(C)CC(=O)OCCc1ccccc1	"rose, peach, apricot, sweet, floral, bitter, fruity"
3-Phenylpropyl Isovalerate	CC(C)CC(=O)OCCCc1ccccc1	"plum, raspberry, strawberry"
FEMA No. 3482	CC(C)CC(=O)Sc1cc(C)oc1C	roasted
4-Methyl-2-Pentanone	CC(C)CC(C)=O	"solvent, spice, herbal, sharp, fruity, dairy, green"
Isovaleric Acid	CC(C)CC(O)=O	"sour, sweat, acid, stinky, sweaty, animal, rancid, tropical, feet, cheese"
"2,6-Dimethyl-4-Heptanol"	CC(C)CC(O)CC(C)C	"fermented, mild, ethereal, fresh, yeasty"
4-Methyl-1-Phenyl-2-Pentanol	CC(C)CC(O)Cc1ccccc1	"herbal, floral, creamy, celery, green"
3-Methylbutanal	CC(C)CC=O	"peach, sour, chocolate, ethereal, malt, fatty, aldehydic"
Butalbital	CC(C)CC1(CC=C)C(=O)NC(=O)NC1=O	bitter
2-Isobutylpyridine	CC(C)Cc1ccccn1	"strong, aromatic"
3-Isobutylpyridine	CC(C)Cc1cccnc1	"strong, aromatic"
2-Isobutyl-3-Methylpyrazine	CC(C)Cc1nccnc1C	"syrup, sugar, herbal, green"
"2-Isobutyl-4-Methyl-1,3-Dioxolane"	CC(C)CC1OCC(C)O1	"sour, ethereal, ripe, sweet, tropical, fruity, dairy, buttery, rummy"
2-Isobutylthiazole	CC(C)Cc1sccn1	"wasabi, privet, vegetable, tomato, earthy, tomato leaf, leaf, metallic, green"
4-Methylpentanoic Acid	CC(C)CCC(O)=O	"pungent, cheese"
Phytol	CC(C)CCC[C@@H](C)CCC[C@@H](C)CCC\C(C)=C\CO	None
"3,7-Dimethyl-1-Octen-3-Ol"	CC(C)CCCC(C)(O)C=C	"wood, citrus, woody, camphor"
6-Methylheptan-2-One	CC(C)CCCC(C)=O	None
"3,7-Dimethyloctanal"	CC(C)CCCC(C)CC=O	"lemon, citrus, aldehydic, green"
"6,10-Dimethyl-2-Undecanone"	CC(C)CCCC(C)CCCC(C)=O	None
Isophytol	CC(C)CCCC(C)CCCC(C)CCCC(C)(O)C=C	None
"6,10,14-Trimethylpentadecan-2-One"	CC(C)CCCC(C)CCCC(C)CCCC(C)=O	"jasmin, herbal, fat, oily, woody, celery"
Pristane	CC(C)CCCC(C)CCCC(C)CCCC(C)C	None
"3,7,11-Trimethyl-1-Dodecanol"	CC(C)CCCC(C)CCCC(C)CCO	None
"3,7-Dimethyl-1-Octanol"	CC(C)CCCC(C)CCO	"waxy, citrus, aldehydic, musty, green, soapy, bitter, leathery"
"1,5-Dimethylhexyl Acetate"	CC(C)CCCC(C)OC(C)=O	"earthy, herbal, undergrowth, humus"
5-Methylhexanoic Acid	CC(C)CCCC(O)=O	"fatty, oily, fruity, cheese"
6-Methylheptanoic Acid	CC(C)CCCCC(O)=O	None
6-Methyl-1-Heptanol	CC(C)CCCCCO	None
Diisooctyl Phthalate	CC(C)CCCCCOC(=O)c1ccccc1C(=O)OCCCCCC(C)C	None
Isoamylamine	CC(C)CCN	"unpleasant, ammonia"
3-Methylbutyl Isothiocyanate	CC(C)CCN=C=S	green
"1-Butanamine, 3-Methyl-N-(3-Methylbutylidene)-"	CC(C)CCN=CCC(C)C	fishy
3-Methyl-1-Butanol	CC(C)CCO	"oil, alcoholic, burnt, whiskey, malt, banana, fusel, fruity"
Isopentyl Benzoate	CC(C)CCOC(=O)c1ccccc1	"sweet, waxy, balsamic, green"
Isoamyl Salicylate	CC(C)CCOC(=O)c1ccccc1O	"wintergreen, tobacco, metallic, floral, soapy, herbal, woody, bitter, orchid"
Isoamyl Acetoacetate	CC(C)CCOC(=O)CC(C)=O	"fermented, ethereal, wine, sweet, green"
Isoamyl Isovalerate	CC(C)CCOC(=O)CC(C)C	"apple, jammy, ripe, sweet, fruity, tropical, mango, green"
Diisoamyl Thiomalate	CC(C)CCOC(=O)CC(S)C(=O)OCCC(C)C	"yeast, fermented, bread, rye, coffee, dark"
102-19-2	CC(C)CCOC(=O)Cc1ccccc1	"chocolate, castoreum, jasmine, animal, cocoa, sweet, honey, balsam, mango"
Isoamyl Acetate	CC(C)CCOC(C)=O	"bitter, solvent, banana, fruity, sweet"
13002-09-0	CC(C)CCOC(C)OCCC(C)C	"alcoholic, fermented, ethereal, fruity, green"
Isopentyl Formate	CC(C)CCOC=O	"blackcurrant, ethereal, vinous, green, earthy, fruit, plum, dry"
Anther	CC(C)CCOCCc1ccccc1	"leafy, fresh, cool, hyacinth, metallic, spring, green"
Isoamyl Mercaptan	CC(C)CCS	"glue, onion"
Isobutylamine	CC(C)CN	"cheesy, fishy"
Isobutyl Isothiocyanate	CC(C)CN=C=S	green
Diisobutylamine	CC(C)CNCC(C)C	bitter
2-Methyl-1-Propanol	CC(C)CO	"solvent, ether, wine, bitter"
Isobutyl Isobutyrate	CC(C)COC(=O)C(C)C	"tropical, pineapple, grape skin"
Isobutyl Benzoate	CC(C)COC(=O)c1ccccc1	"powdery, musty, sweet, fruity, balsam"
Diisobutyl Phthalate	CC(C)COC(=O)c1ccccc1C(=O)OCC(C)C	None
Isobutyl Anthranilate	CC(C)COC(=O)c1ccccc1N	"berry, grape, floral, sweet, fruity"
Isobutyl Salicylate	CC(C)COC(=O)c1ccccc1O	"herbal, floral, clover, bitter, orchid"
Isobutyl Isovalerate	CC(C)COC(=O)CC(C)C	"apple, banana, sweet, fruity, raspberry, green"
Isobutyl Phenylacetate	CC(C)COC(=O)Cc1ccccc1	"chocolate, amber, floral, sweet, honey"
Isobutyl Furfurylacetate	CC(C)COC(=O)CCc1occc1	"pineapple, floral, woody, sweet, fruity"
Diisobutyl Adipate	CC(C)COC(=O)CCCCC(=O)OCC(C)C	"estery, mild"
Isobutyl Undecylenate	CC(C)COC(=O)CCCCCCCCC=C	"fatty, fruity"
Isobutyl Acetate	CC(C)COC(C)=O	"apple, sweet, fruity, tropical, fruit, ethereal, bitter, banana"
Phenylacetaldehyde Diisobutyl Acetal	CC(C)COC(Cc1ccccc1)OCC(C)C	"cortex, rose, floral, sweet, almond, green"
Isobutyl Formate	CC(C)COC=O	"ether, sweet, fruity, chemical"
2-Isobutoxynaphthalene	CC(C)COc1ccc2ccccc2c1	"orange, strawberry, sweet, naphthyl, fruity, blossom"
Isobutyl Mercaptan	CC(C)CS	"mustard, vegetable, cooked"
Isopropylamine	CC(C)N	"ammoniacal, fishy"
Isopropyl Isothiocyanate	CC(C)N=C=S	"mustard, pungent"
Isopropanol	CC(C)O	"woody, bitter, musty, alcohol"
Isopropyl Isobutyrate	CC(C)OC(=O)C(C)C	"citrus, pineapple, sweet, fruity, pear"
Isopropyl Benzoate	CC(C)OC(=O)c1ccccc1	"balsamic, floral, fruit, sweet, fruity"
Isopropyl Phenylacetate	CC(C)OC(=O)Cc1ccccc1	"honeysuckle, sweet, powdery, winey"
Diisopropyl Adipate	CC(C)OC(=O)CCCCC(=O)OC(C)C	"fatty, sour, estery, mild"
Isopropyl Acetate	CC(C)OC(C)=O	"ethereal, chemical, banana, sweet, fruity"
Isopropyl Formate	CC(C)OC=O	"ethereal, cocoa, tropical, solvent"
2-Isopropoxy-5-Nitroaniline	CC(C)Oc1ccc(cc1N)[N+]([O-])=O	sweet-like
2-Propanethiol	CC(C)S	"sulfurous, onion, ripe, gassy, strong, meaty"
34365-79-2	CC(C)SC(=O)C=C(C)C	"alliaceous, galbanum, green"
Diisopropyl Sulfide	CC(C)SC(C)C	"garlic, vegetable, sulfury"
Furfuryl Isopropyl Sulfide	CC(C)SCc1occc1	"savory, coffee, floral, meaty"
Diisopropyl Disulfide	CC(C)SSC(C)C	"cabbage, sulfurous, onion, alliaceous, meaty"
Diisopropyl Trisulfide	CC(C)SSSC(C)C	"garlic, sulfury"
4-Methylhydratropaldehyde	CC(C=O)c1ccc(C)cc1	"powdery, herbal, floral, sweet, woody, green"
2-Phenylpropanal	CC(C=O)c1ccccc1	"lilac, sharp, fresh, floral, leaf, hyacinth, green"
"1,3-Diphenyl-1-Butanone"	CC(CC(=O)c1ccccc1)c2ccccc2	None
"2,2,4,6,6-Pentamethylheptane"	CC(CC(C)(C)C)CC(C)(C)C	None
Chloralodol	CC(CC(C)(C)O)OC(O)C(Cl)(Cl)Cl	bitter
3-(4-Methylcyclohex-3-En-1-Yl)Butanal	CC(CC=O)C1CCC(=CC1)C	"sweet, sandalwood"
"3,5,5-Trimethylhexanal"	CC(CC=O)CC(C)(C)C	"citrus, green, fatty, aldehydic, grassy, weedy, natural, dry"
1335-48-4	CC(CCC\C(C)=C\CO)CCC=C(C)C	None
"2,6-Dimethyl-5-Heptenal"	CC(CCC=C(C)C)C=O	"lemon, peach, cantaloupe, clean, ozone, vegetable, fatty, earthy, woody, melon, nutty, wine_like, meaty, spicy, citrus, fruit, herbaceous, green, cucumber, fresh air, floral, watermelon, sweet, fruity, grapefruit"
Beta-Bisabolol	CC(CCC=C(C)C)C1(O)CCC(=CC1)C	"lemon, citrus, herbal, fresh, floral, sweet, tangy, herb"
Curcumene	CC(CCC=C(C)C)c1ccc(C)cc1	herb
Citronellic Acid	CC(CCC=C(C)C)CC(O)=O	"smoky, fatty, floral, grassy, green"
Citronellal	CC(CCC=C(C)C)CC=O	"lemon, citrus, rose, fat, herbal, waxy, floral, sweet, aldehydic, cherry, dry"
6-Methylhept-5-En-2-Yl Acetate	CC(CCC=C(C)C)OC(C)=O	fruity
2-Methyl-4-Phenylbutanal	CC(CCc1ccccc1)C=O	"floral, earthy, sweet, musty"
4-Phenyl-2-Butyl Acetate	CC(CCc1ccccc1)OC(C)=O	"fruit, green"
Dihydromyrcenol	CC(CCCC(C)(C)O)C=C	"tart lime, citrus, lime, fresh, floral, clean, cologne, weedy"
Hydroxycitronellal	CC(CCCC(C)(C)O)CC=O	"waxy, floral, lily, sweet, tropical, melon, green"
Rhodinyl Phenylacetate	CC(CCCC(C)=C)CCOC(=O)Cc1ccccc1	"powdery, red rose, waxy, floral, honey, geranium"
Rhodinyl Acetate	CC(CCCC(C)=C)CCOC(C)=O	"spicy, powdery, citrus, red rose, geranium, bitter"
Citronellylacetone	CC(CCCC(C)=O)CCC=C(C)C	"rose, floral, sweet, woody, balsam"
"3,5,5-Trimethylhexan-1-Ol"	CC(CCO)CC(C)(C)C	"floral, earthy, hay, straw, leaf, aldehydic, grassy, weedy, green"
(-)-Citronellol	CC(CCO)CCC=C(C)C	"oil, powdery, rose, waxy, floral, geranium"
Citronellol	CC(CCO)CCC=C(C)C	"waxy, bitter, citrus, rose, leather, geranium, floral, rose bud"
Citronellyl Isobutyrate	CC(CCOC(=O)C(C)C)CCC=C(C)C	"rose, floral, fruit, sweet, fruity, tropical, geranium"
Rhodinyl Isobutyrate	CC(CCOC(=O)C(C)C)CCC=C(C)C	None
Citronellyl Anthranilate	CC(CCOC(=O)c1ccccc1N)CCC=C(C)C	"neroli, rose, sweet, fruity, petitgrain"
Citronellyl Phenylacetate	CC(CCOC(=O)Cc1ccccc1)CCC=C(C)C	"rose, waxy, fresh, sweet, honey"
Citronellyl Acetate	CC(CCOC(C)=O)CCC=C(C)C	"lemon, citrus, rose, floral, fruit, woody, fruity, tropical, dust, green"
Citronellyl Formate	CC(CCOC=O)CCC=C(C)C	"peach, apricot, rose, plum, honey, bergamot, cucumber"
Rhodinyl Formate	CC(CCOC=O)CCC=C(C)C	"leaf, geranium, green, floral, bitter, rose dried"
Citronellyloxyacetaldehyde	CC(CCOCC=O)CCC=C(C)C	"honeysuckle, waxy, fresh, floral, muguet, sweet, aldehydic"
Clobutinol	CC(CN(C)C)C(C)(O)Cc1ccc(Cl)cc1	bitter
P-Menth-1-En-9-Ol	CC(CO)C1CCC(=CC1)C	"fruit, herbal, fruity, herb"
2-Phenylpropan-1-Ol	CC(CO)c1ccccc1	"honeysuckle, lilac, balsam, hyacinth, spicy, green"
"1,2-Diacetoxypropane"	CC(COC(C)=O)OC(C)=O	"acetic, fruity"
Iodinated Glycerol	CC(I)C1OCC(CO)O1	bitter
Acetamide	CC(N)=O	mousy
Dl-Alanyl-Dl-Phenylalanine	CC(N)C(=O)NC(Cc1ccccc1)C(O)=O	sweet
Dl-Alanine	CC(N)C(O)=O	odorless
Phenaminum	CC(N)Cc1ccccc1.CC(N)Cc2ccccc2.O[S](O)(=O)=O	bitter
Amphetamine Phosphate	CC(N)Cc1ccccc1.O[P](O)(O)=O	bitter
Acetic Acid	CC(O)=O	"sour, pungent, sharp, vinegar"
"Bicyclo[7.2.0]Undec-3-En-5-Ol, 4,11,11-Trimethyl-8-Methylene-, Acetate"	CC(O)=O.CC1=CCC2C(CC2(C)C)C(=C)CCC1O	None
2-Methylfuran-3-Thiol Acetate	CC(O)=O.Cc1occc1S	"sulfurous, roasted, meat, egg, roasted meat"
Croscarmellose	CC(O)=O.OCC(O)C(O)C(O)C(O)C=O	"odorless, sweet"
Thioacetic Acid	CC(O)=S	"meaty, roasted, cooked"
N-(2-Hydroxyethyl)Lactamide	CC(O)C(=O)NCCO	"roasted, cooked"
Acetoin	CC(O)C(C)=O	"butter, cream, milky, fatty, creamy, sweet, dairy, buttery"
"2,3-Butanediol"	CC(O)C(C)O	"onion, fruit, creamy, fruity, buttery"
3-Gpxbt	CC(O)C(C)O[C@@H]1O[C@H](CO)[C@@H](O)[C@H](O)[C@H]1O	sweet
3-Mercapto-2-Butanol	CC(O)C(C)S	sulfurous
3-((2-Mercapto-1-Methylpropyl)Thio)-2-Butanol	CC(O)C(C)SC(C)C(C)S	"burnt, sulfurous, roasted, fatty, meaty"
Lactic Acid	CC(O)C(O)=O	odorless
Antibiotic SF 666	CC(O)C(O)C(O)C(O)C(O)C=O	sweet
3615-41-6	CC(O)C(O)C(O)C(O)C=O	sweet
4-Phenyl-3-Buten-2-Ol	CC(O)C=Cc1ccccc1	"floral, sweet, fruity, balsam"
1-(4-Methylphenyl)Ethanol	CC(O)c1ccc(C)cc1	"powdery, floral, sweet, hawthorn, nutty"
1-Phenylethanol	CC(O)c1ccccc1	"acetophenone, gardenia, fresh, sweet, hyacinth"
4-Penten-2-Ol	CC(O)CC=C	None
6-Methylhept-5-En-2-Ol	CC(O)CCC=C(C)C	"oily, coriander, sweet, green"
Dehydrodihydroionol	CC(O)CCC1=C(C)C=CCC1(C)C	None
4-Phenyl-2-Butanol	CC(O)CCc1ccccc1	"foliage, peony, heliotrope, floral, sweet, mimosa"
"1,3-Butanediol"	CC(O)CCO	"odorless, bitter"
Dyskinebyl	CC(O)CCOCCC(C)O	bitter
"1,2-Propanediol"	CC(O)CO	"alcoholic, very slight, odorless"
68445-41-0	CC(O)CO[C@H]1O[C@H](CO)[C@@H](O[C@@H]2O[C@H](CO)[C@@H](O)[C@H](O)[C@H]2O)[C@H](O)[C@H]1O	sweet
1-Phenylethyl Acetate	CC(OC(C)=O)c1ccccc1	"bitter, rhubarb, gardenia, musty, floral, green, sweet, herbal, leafy, fruity"
3-Mercapto-2-Butanone	CC(S)C(C)=O	"sulfurous, roasted, onion, gassy, meaty"
2-Mercaptopropionic Acid	CC(S)C(O)=O	"sulfurous, roasted, meaty"
1-Phenylethanethiol	CC(S)c1ccccc1	"floral, sulfurous, tropical, meaty"
"1,2-Propanedithiol"	CC(S)CS	None
Ethanedithiol	CC(S)S	"roasted, meaty"
Quebrachamine	CC[C@@]12CCCN(CCc3c(CC1)[nH]c4ccccc34)C2	bitter
Glaucarubin	CC[C@](C)(O)C(=O)O[C@@H]1[C@H]2[C@@H](C)[C@@H](O)[C@]3(O)OC[C@]24[C@@H](C[C@H]5C(=C[C@H](O)[C@@H](O)[C@]5(C)[C@@H]34)C)OC1=O	bitter
L-Isoleucine	CC[C@H](C)[C@H](N)C(O)=O	"odorless, bitter"
Clarithromycin	CC[C@H]1OC(=O)[C@H](C)[C@@H](O[C@H]2C[C@@](C)(OC)[C@@H](O)[C@H](C)O2)[C@H](C)[C@@H](O[C@@H]3O[C@H](C)C[C@@H]([C@H]3O)N(C)C)[C@@](C)(C[C@@H](C)C(=O)[C@H](C)[C@@H](O)[C@]1(C)O)OC	bitter
Erythromycin	CC[C@H]1OC(=O)[C@H](C)[C@@H](O[C@H]2C[C@@](C)(OC)[C@@H](O)[C@H](C)O2)[C@H](C)[C@@H](O[C@@H]3O[C@H](C)C[C@@H]([C@H]3O)N(C)C)[C@](C)(O)C[C@@H](C)C(=O)[C@H](C)[C@@H](O)[C@]1(C)O	bitter
Bretylium Tosylate	CC[N+](C)(C)Cc1ccccc1Br.Cc2ccc(cc2)[S]([O-])(=O)=O	bitter
Denatonium Benzoate	CC[N+](CC)(CC(=O)Nc1c(C)cccc1C)Cc2ccccc2.[O-]C(=O)c3ccccc3	bitter
2-Methyl-2-Buten-1-Ol	CC=C(C)CO	None
Ethylidene Glucose	CC=C(O)[C@@H](O)[C@@H](O)[C@H](O)[C@@H](O)C=O	sweet
2-Methylpropyl But-2-Enoate	CC=CC(=O)OCC(C)C	None
"2,4-Hexadienyl Isobutyrate"	CC=CC=CCOC(=O)C(C)C	None
Acetaldehyde	CC=O	"ethereal, ether, whiskey, pungent, fruity, aldehydic"
Heptobarbital	CC1(C(=O)NC(=O)NC1=O)c2ccccc2	bitter
Glycyrrhizic Acid	CC1(C)[C@H](CC[C@@]2(C)[C@H]1CC[C@]3(C)[C@@H]2C(=O)C=C4[C@@H]5C[C@](C)(CC[C@]5(C)CC[C@@]34C)C(O)=O)O[C@H]6O[C@@H]([C@@H](O)[C@H](O)[C@H]6O[C@@H]7O[C@@H]([C@@H](O)[C@H](O)[C@H]7O)C(O)=O)C(O)=O	"sweet, mild, spicy"
Alpha-Glycyrrhizin	CC1(C)[C@H](CC[C@@]2(C)[C@H]1CC[C@]3(C)[C@@H]2C(=O)C=C4[C@H]5C[C@](C)(CC[C@]5(C)CC[C@@]34C)C(O)=O)O[C@H]6O[C@@H]([C@@H](O)[C@H](O)[C@H]6O[C@@H]7O[C@@H]([C@@H](O)[C@H](O)[C@H]7O)C(O)=O)C(O)=O	sweet-like
D-Camphor	CC1(C)[C@H]2CC[C@@]1(C)C(=O)C2	"phenolic, minty, camphor, medicinal, herbal, woody, bitter"
L-Alpha-Fenchone	CC1(C)[C@H]2CC[C@](C)(C2)C1=O	"earthy, woody, herbal, camphor"
Uralsaponin A	CC1(C)C(CC[C@@]2(C)C1CC[C@]3(C)C2C(=O)C=C4C5C[C@](C)(CC[C@]5(C)CCC34C)C(O)=O)O[C@@H]6O[C@H](CO)[C@@H](O)[C@H](O)[C@H]6O[C@@H]7O[C@H](CO)[C@@H](O)[C@H](O)[C@H]7O	sweet-like
82793-03-1	CC1(C)C[C@H](O)[C@]2(C)CC[C@]3(C)C(=CCC4[C@@]5(C)CCC(O[C@@H]6O[C@@H]([C@H](O)[C@H](O)[C@H]6O[C@@H]7O[C@H](CO)[C@@H](O)[C@H](O)[C@H]7O)C(O)=O)C(C)(CO)C5CC[C@@]34C)[C@H]2C1	sweet-like
Pinocarveol	CC1(C)C2CC(O)C(=C)C1C2	"herbal, woody, balsam, pine, camphor"
Myrtenal	CC1(C)C2CC=C(C=O)C1C2	"lime, spice, jam, pepper, sweet, tonka, terpene, camphor, spicy, cinnamon"
Nopol	CC1(C)C2CC=C(CCO)C1C2	"citrus, balsamic, herbal, sweet, pine"
Myrtenol	CC1(C)C2CC=C(CO)C1C2	"mint, medical, woody, sweet, balsam, pine"
Pinocarvone	CC1(C)C2CC1C(=C)C(=O)C2	minty
Beta-Pinene	CC1(C)C2CCC(=C)C1C2	"resinous, resin, turpentine, green, hay, woody, pine, dry"
Psi-Carene	CC1(C)C2CCC(=C)CC12	orange peel
Terpinyl Formate	CC1(C)C2CCC(C)(C1C2)C3(C)CCC4CC3(C4(C)C)C5(C)CCC6CC5C6(C)C.OC=O	"citrus, floral, bitter, fruity, lavender"
Fenchone	CC1(C)C2CCC(C)(C2)C1=O	"earthy, cedarleaf, camphor, thuja, herbal, woody, bitter"
Fenchol	CC1(C)C2CCC(C)(C2)C1O	"dry, lemon, borneol, sweet, pine, camphor, woody, bitter"
2-Pinanethiol	CC1(C)C2CCC(C)(S)C1C2	"sulfurous, grapefruit"
Camphene	CC1(C)C2CCC(C2)C1=C	"fir needle, woody, herbal, camphor"
(+)-Camphene	CC1(C)C2CCC(C2)C1=C	"fir, herbal, fresh, woody, camphor"
Camphor	CC1(C)C2CCC1(C)C(=O)C2	"camphoreous, camphor"
Isobornyl Benzoate	CC1(C)C2CCC1(C)C(C2)OC(=O)c3ccccc3	"balsam, pine, balsamic"
Borneol	CC1(C)C2CCC1(C)C(O)C2	"woody, pine, camphor"
Alpha-Fenchene	CC1(C)C2CCC1C(=C)C2	camphor
"2,10-Epoxypinane"	CC1(C)C2CCC3(CO3)C1C2	None
Chikusetsusaponin V	CC1(C)CC[C@@]2(CC[C@]3(C)C(=CCC4[C@@]5(C)CCC(O[C@@H]6O[C@@H]([C@@H](O)[C@H](O)[C@H]6O[C@@H]7O[C@H](CO)[C@@H](O)[C@H](O)[C@H]7O)C(O)=O)C(C)(C)C5CC[C@@]34C)[C@H]2C1)C(=O)O[C@@H]8O[C@H](CO)[C@@H](O)[C@H](O)[C@H]8O	sweet-like
Beta-Caryophyllene Alcohol	CC1(C)CC2C1CCC3(C)CCCC2(O)C3	"warm, moss, earthy, woody, earth, spicy"
"2,6,6-Trimethyl-2-Hydroxycyclohexanone"	CC1(C)CCCC(C)(O)C1=O	"tobacco, sweet, herbal"
"3,3-Dimethylcyclohexanol"	CC1(C)CCCC(O)C1	None
Sclareolide	CC1(C)CCCC2(C)C1CCC3(C)OC(=O)CC23	"ambergris, paper, woody, labdanum, dry"
3738-00-9	CC1(C)CCCC2(C)C1CCC3(C)OCCC23	"ambergris, old paper, sweet, labdanum, dry"
"4,4,7a-Trimethyl-5,6,7,7a-Tetrahydrobenzofuran-2(4H)-One"	CC1(C)CCCC2(C)OC(=O)C=C12	"red fruit, coumarin, woody, musk, ripe apricot"
14049-11-7	CC1(C)OC(C)(CCC1O)C=C	"floral, flower"
"Alpha-L-Sorbopyranose, 1,2-O-(1-Methylethylidene)-"	CC1(C)OC[C@]2(OC[C@H](O)[C@@H](O)[C@@H]2O)O1	sweet
Trithioacetone	CC1(C)SC(C)(C)SC(C)(C)S1	"burnt, sulfurous, earthy, blackberry, green"
Spathulenol	CC1(O)CCC2[C@@H]1C3C(CCC2=C)C3(C)C	None
"2,5-Dimethyl-1,4-Dithiane-2,5-Diol"	CC1(O)CSC(C)(O)CS1	"bouillon, onion, pork, savory, lamb, chicken"
Picrocrocin	CC1=C(C=O)C(C)(C)CC(C1)O[C@@H]2O[C@H](CO)[C@@H](O)[C@H](O)[C@H]2O	bitter
Safranal	CC1=C(C=O)C(C)(C)CC=C1	"spicy, tobacco, herbal, fresh, sweet, rosemary, metallic, herb, phenolic"
Beta-Cyclocitral	CC1=C(C=O)C(C)(C)CCC1	"mint, saffron, tobacco, herbal, damascone, sweet, tropical, clean, fruity, rose oxide, minty"
"2,6,6-Trimethyl-1-Cyclohexene-1-Acetaldehyde"	CC1=C(CC=O)C(C)(C)CCC1	"cooling, woody, fruity, weedy, beef, camphor"
Maltol	CC1=C(O)C(=O)C=CO1	"caramel, jam, bread, cotton, sweet, fruity, baked, candy"
80-71-7	CC1=C(O)C(=O)CC1	"caramel, smoky, maple syrup, maple"
Terpinen-4-Ol	CC1=C2CC(CC1C3(CC4CC(=C3C)C4(C)C)C5C(O)C6CC(=C5C)C6(C)C)C2(C)C	"must, pepper, turpentine, musty, woody, sweet, nutmeg, earth"
Verbenone	CC1=CC(=O)C2CC1C2(C)C	None
Verbenone	CC1=CC(=O)C2CC1C2(C)C	"celery, menthol, camphor"
Isophorone	CC1=CC(=O)CC(C)(C)C1	"cooling, tobacco, cedarwood, leather, musty, woody, sweet, fruity, camphoraceous, camphor, green"
3-Methyl-2-Cyclopenten-1-One	CC1=CC(=O)CC1	"fatty, sweet, fruity"
3-Methyl-2-Cyclohexen-1-One	CC1=CC(=O)CCC1	"cherry, caramel, nut, phenolic"
Acesulfame	CC1=CC(=O)N[S](=O)(=O)O1	bitter
Verbenol	CC1=CC(O)C2CC1C2(C)C	"pine, fresh, ozone"
7785-70-8	CC1=CC[C@@H]2C[C@H]1C2(C)C	None
Cycloionone	CC1=CC=C2C(C)(C)CCCC2(C)O1	None
"1-Methyl-1,3-Cyclohexadiene"	CC1=CC=CCC1	fruity
Pemirolast	CC1=CC=CN2C(=O)C(=CN=C12)c3n[nH]nn3	bitter
34545-88-5	CC1=CC2=CC(=O)CCC2CC1	"coconut, toasted, tonka"
Alpha-Angelica Lactone	CC1=CCC(=O)O1	None
"4-Acetyl-1,4-Dimethyl-1-Cyclohexene"	CC1=CCC(C)(CC1)C(C)=O	fruity
Alpha-TERPINEOL	CC1=CCC(CC1)C(C)(C)O	None
Alpha-Terpinyl Anthranilate	CC1=CCC(CC1)C(C)(C)OC(=O)c2ccccc2N	"bitter, lily, fruity, orange blossom"
2-Methyl-2-(4-Methyl-3-Cyclohexen-1-Yl)Oxirane	CC1=CCC(CC1)C2(C)CO2	"citrus, fresh"
1901-38-8	CC1=CCC(CCO)C1(C)C	"sweet, berry, camphor"
Alpha-Eudesmol	CC1=CCC[C@]2(C)CC[C@H](C[C@@H]12)C(C)(C)O	None
3-Carene	CC1=CCC2C(C1)C2(C)C	"lemon, citrus, sweet, resin"
Alpha-Pinene	CC1=CCC2CC1C2(C)C	"harsh, turpentine, minty, fresh, earthy, sweet, woody, terpene, pine, camphor"
"2-Methyl-1,3-Cyclohexadiene"	CC1=CCCC=C1	None
3-Methyl-2(5H)-Furanone	CC1=CCOC1=O	None
2-Methyl-2-Thiazoline	CC1=NCCS1	"musty, nutty, sulfurous, meaty"
Eucalyptol	CC12CCC(CC1)C(C)(C)O2	"mint, pepper, herbal, eucalyptus, sweet, camphor"
Musk Xylene	Cc1c(c(C)c(c(c1[N+]([O-])=O)C(C)(C)C)[N+]([O-])=O)[N+]([O-])=O	musky
Carmine	Cc1c(C(O)=O)c(O)cc2C(=O)c3c(O)c(O)c([C@H]4O[C@H](CO)[C@@H](O)[C@H](O)[C@H]4O)c(O)c3C(=O)c12	None
Musk Tibetene	Cc1c(C)c(c(c(c1C)[N+]([O-])=O)C(C)(C)C)[N+]([O-])=O	musky
Moskene	Cc1c(cc2c(c1[N+]([O-])=O)C(C)(C)CC2(C)C)[N+]([O-])=O	musky
Clonixin	Cc1c(Cl)cccc1Nc2ncccc2C(O)=O	bitter
3-Methylindole	Cc1c[nH]c2ccccc12	"very strong, mothball, animal, fecal, indole, civet"
Grosheimin	CC1C2C(CC1=O)C(=C)CC(O)C3C2OC(=O)C3=C	bitter
Pinocamphone	CC1C2CC(CC1=O)C2(C)C	None
3407-42-9	CC1C2CC(CC2C3CCCC(O)C3)C1(C)C	"woody, sweet, sandalwood, clean"
1423-46-7	CC1CC(=CC(C)C1C=O)C	"herbal, earthy, woody, leaf, aldehydic, green"
"2-Cyclopenten-1-One, 2-Hydroxy-3,4-Dimethyl-"	CC1CC(=O)C(=C1C)O	None
"3,4-Dimethyl-1,2-Cyclopentanedione"	CC1CC(=O)C(=O)C1C	"caramel, licorice, sweet, anise, sugar, balsam, maple, fenugreek"
4674-50-4	CC1CC(=O)C=C2CCC(CC12C)C(C)=C	"grapefruit peel, citrus, gardenia, woody, grapefruit"
"2,6-Di-Tert-Butyl-4-Methylphenol"	Cc1cc(c(O)c(c1)C(C)(C)C)C(C)(C)C	"mild, vanilla, musty, camphor, phenolic"
Tonalid	CC1CC(C)(C)c2cc(C(C)=O)c(C)cc2C1(C)C	musky
"2,4,6-Trimethyl-4-Phenyl-1,3-Dioxane"	CC1CC(C)(OC(C)O1)c2ccccc2	"citrus, gardenia, fresh, natural, green"
13494-07-0	CC1CC(C)C(=O)C1=O	"caramel, sweet, maple"
"1,2,4,5-Tetramethylbenzene"	Cc1cc(C)c(C)cc1C	"rancid, sweet"
"2,4,6-Trimethylphenol"	Cc1cc(C)c(O)c(C)c1	"phenolic, mild"
Mesitylene	Cc1cc(C)cc(C)c1	None
89-88-3	CC1CC(O)C=C(C)C2CC(CC12)=C(C)C	None
"3,3,5-Trimethylcyclohexanol"	CC1CC(O)CC(C)(C)C1	"mint, mentholic, musty, cool, spicy"
Vetiveryl Acetate	CC1CC(OC(C)=O)C=C(C)C2CC(CC12)=C(C)C	"powdery, sandal, root, vetiver, woody, sweet, dry"
4-Menthen-8-Ol	CC1CCC(=CC1)C(C)(C)O	"metal, ginger"
"3-Methylcyclopentane-1,2-Dione"	CC1CCC(=O)C1=O	None
4-Methylcyclohexanone	CC1CCC(=O)CC1	"musty, animal"
Gamma-Valerolactone	CC1CCC(=O)O1	"tobacco, warm, herbal, cocoa, sweet, woody"
P-Mentha-8-Thiol-3-One	CC1CCC(C(=O)C1)C(C)(C)S	"peach, berry, sulfury, buchu, fruity, tropical, minty, green"
57074-34-7	CC1CCC(C(=O)C1)C(C)(C)SC(C)=O	None
Isopulegone	CC1CCC(C(C)=C)C(=O)C1	"herbal, fresh, peppermint"
P-Menth-8-En-3-Ol	CC1CCC(C(O)C1)C(C)=C	"cooling, herbal, woody, minty, grassy, medicinal, green"
"1,2,4-Trimethylbenzene"	Cc1ccc(C)c(C)c1	plastic
"2,5-Dimethylphenol"	Cc1ccc(C)c(O)c1	"bacon, sweet, naphthyl, phenolic, smoke"
"2,3,6-Trimethylphenol"	Cc1ccc(C)c(O)c1C	None
P-Xylene	Cc1ccc(C)cc1	None
"2,4-Dimethylbenzaldehyde"	Cc1ccc(C=O)c(C)c1	"spice, vanilla, naphthyl, cherry, almond"
2-Hydroxy-4-Methylbenzaldehyde	Cc1ccc(C=O)c(O)c1	"almond, bitter, phenolic"
P-Tolualdehyde	Cc1ccc(C=O)cc1	"cherry, deep, fruity, phenolic"
104-09-6	Cc1ccc(CC=O)cc1	"cortex, lilac, fresh, narcissus, sweet, green"
P-MENTHAN-8-OL	CC1CCC(CC1)C(C)(C)O	"lime, woody, sweet, pine, terpenic"
2-(4-Methylphenyl)Propan-2-Ol	Cc1ccc(cc1)C(C)(C)O	"citrus, coumarin, must, floral, sweet, fruity, cherry, camphor"
P-Menthane	CC1CCC(CC1)C(C)C	pine
4-Methylbiphenyl	Cc1ccc(cc1)c2ccccc2	"mint, fennel, waxy, floral, wintergreen, anise, spicy"
Dihydrocarvone	CC1CCC(CC1=O)C(C)=C	"warm, powerful, herbal, minty, spearmint"
Dihydrocarveol	CC1CCC(CC1O)C(C)=C	"mint, spice, herbal, menthol, minty, spearmint"
Dihydrocarvyl Acetate	CC1CCC(CC1OC(C)=O)C(C)=C	"mint, cuminseed, rose, floral, sweet, minty, medicine, medicinal, camphor"
Guaiene	CC1CCC(CC2=C1CCC2C)=C(C)C	"guaiacwood, powdery, spice, sweet, woody, wood, spicy, dry"
Guaicwood Acetate	CC1CCC(CC2=C1CCC2C)C(C)(C)OC(C)=O	"rose, fatty, woody, tea, spicy, green"
4-Methylbenzyl Alcohol	Cc1ccc(CO)cc1	"floral, mild"
4-Fluorotoluene	Cc1ccc(F)cc1	bitter
"2,4-Dimethylcyclohexanol"	CC1CCC(O)C(C)C1	None
1450-72-2	Cc1ccc(O)c(c1)C(C)=O	"floral, heavy, sweet, herbal"
P-Cresol	Cc1ccc(O)cc1	"smoke, animal, narcissus, phenol, mimosa, medicine, medicinal, phenolic"
"3,4-Dimethylphenol"	Cc1ccc(O)cc1C	"flat, dry"
P-Tolyl Phenylacetate	Cc1ccc(OC(=O)Cc2ccccc2)cc1	"rose, animal, narcissus, lily, honey, hyacinth"
Quinovic Acid	CC1CCC2(CCC3(C(O)=O)C(=CCC4C5(C)CC[C@H](O)C(C)(C)C5CCC34C)C2C1C)C(O)=O	bitter
Theaspirane	CC1CCC2(O1)C(=CCCC2(C)C)C	"tobacco, wet, metallic, herbal, woody, leaf, tea, spicy, green"
6-Hydroxydihydrotheaspirane	CC1CCC2(O1)C(C)(C)CCCC2(C)O	None
6-Acetoxydihydrotheaspirane	CC1CCC2(O1)C(C)(C)CCCC2(C)OC(C)=O	None
Bulnesol	CC1CCC2=C(C)CCC(CC12)C(C)(C)O	"spicy, spice"
Cedr-8(15)-En-9-Ol	CC1CCC2C(C)(C)C3CC12CC(O)C3=C	"soft, cedarwood, fruit, woody, sweet"
"1,1,6-Trimethyl-1,2-Dihydronaphthalene"	Cc1ccc2c(C=CCC2(C)C)c1	licorice
"1,1,6-Trimethyltetralin"	Cc1ccc2c(CCCC2(C)C)c1	None
Globulol	CC1CCC2C1C3C(CCC2(C)O)C3(C)C	"floral, rose"
Aromadendrene	CC1CCC2C1C3C(CCC2=C)C3(C)C	"wood, woody"
"2,6-Dimethylnaphthalene"	Cc1ccc2cc(C)ccc2c1	grass
"2,8-Epithio-P-Menthane"	CC1CCC2CC1SC2(C)C	"grapefruit peel, soupy, sulfury, fresh, fir needle, tropical, minty, seedy"
2-Methylnaphthalene	Cc1ccc2ccccc2c1	None
6-Methylquinoline	Cc1ccc2ncccc2c1	"tobacco, castoreum, leather, fecal, civet, tonka"
6-Methylcoumarin	Cc1ccc2OC(=O)C=Cc2c1	"coconut, powdery, sweet, vanilla, anise, balsam, creamy, floral, bitter"
3-Methylcyclohexanone	CC1CCCC(=O)C1	"camphoraceous, minty, medicinal, camphor"
Delta-Hexalactone	CC1CCCC(=O)O1	"sweet, herbal"
"2,2,6-Trimethylcyclohexanone"	CC1CCCC(C)(C)C1=O	"pungent, honey, cistus, labdanum, thujone"
M-Xylene	Cc1cccc(C)c1	plastic
"2,6-Dimethylphenol"	Cc1cccc(C)c1O	"rooty, coffee, sweet, medicinal, phenolic"
"2,6-Dimethylthiophenol"	Cc1cccc(C)c1S	"roasted, sulfurous, sulfury, metallic, meaty, phenolic"
"2,6-Dimethylpyridine"	Cc1cccc(C)n1	"bready, oily, woody, cocoa, nutty, amine"
"2,6-Dimethylpiperidine"	CC1CCCC(C)N1	bitter
3-Methylbenzaldehyde	Cc1cccc(C=O)c1	"benzaldehyde, sweet, fruity, cherry, phenolic"
Mefenamic Acid	Cc1cccc(Nc2ccccc2C(O)=O)c1C	bitter
M-Cresol	Cc1cccc(O)c1	"medical, leather, woody, fecal, phenolic, medicinal, plastic"
"2,3-Dimethylphenol"	Cc1cccc(O)c1C	"musty, chemical, phenolic"
"4a(2H)-Naphthol, Octahydro-4,8a-Dimethyl-"	CC1CCCC2(C)CCCCC12O	"soil, beet, fresh, earthy, musty, earth"
1-Methylnaphthalene	Cc1cccc2ccccc12	"naphthyl, medicinal, chemical, camphor"
5-Methylquinoxaline	Cc1cccc2nccnc12	"burnt, roasted, toasted, coffee, nutty, corn"
Toluene	Cc1ccccc1	"paint, sweet"
Methylcyclohexane	CC1CCCCC1	None
2-Methylcyclohexanone	CC1CCCCC1=O	"minty, peppermint"
O-Xylene	Cc1ccccc1C	geranium
2-Methylbenzaldehyde	Cc1ccccc1C=O	cherry
O-Cresol	Cc1ccccc1O	"phenol, musty, medicinal, phenolic"
O-Tolyl Salicylate	Cc1ccccc1OC(=O)c2ccccc2O	"eucalyptus, herbal"
Mephenesin	Cc1ccccc1OCC(O)CO	bitter
2-Methylbenzenethiol	Cc1ccccc1S	"rubber, sulfurous, garlic, onion, egg, meaty"
Muscone	CC1CCCCCCCCCCCCC(=O)C1	"powdery, animal, fatty, sweet, musk, natural"
2-Methylpiperidine	CC1CCCCN1	"taco, fishy, seafood, amine, corn, chip"
2-Methylpyridine	Cc1ccccn1	"bitter, sweat"
"2,4-Lutidine"	Cc1ccnc(C)c1	None
Rose Oxide	CC1CCOC(C1)C=C(C)C	"red rose, fresh, geranium, spicy, green"
"2,3,5-Trimethylpyrazine"	Cc1cnc(C)c(C)n1	"hazelnut, roast, roasted, powdery, potato, must, musty, earthy, cocoa, peanut, nutty"
"2,5-Dimethylpyrazine"	Cc1cnc(C)cn1	"roast beef, roasted nuts, grass, medical, cocoa, woody, medicine, roasted nut, medicinal"
2-Methyl-5-Vinylpyrazine	Cc1cnc(C=C)cn1	coffee
2-Methylquinoxaline	Cc1cnc2ccccc2n1	"roast, nut, toasted, fruit, coffee, fruity, nutty"
"2,6-Dimethylpyrazine"	Cc1cncc(C)n1	"roast beef, roasted nuts, coffee, cocoa, roasted nut"
2-Methylpyrazine	Cc1cnccn1	"chocolate, roasted, cocoa, peanut, nutty, popcorn, green"
Propylene Oxide	CC1CO1	"ethereal, sweet"
"2,2,4-Trimethyl-1,3-Dioxolane"	CC1COC(C)(C)O1	"raw, potato, vegetable, earthy, green"
68258-95-7	CC1COC(C)(CCC=C(C)C)O1	"fatty, citrus, green"
"2,4-Dimethyl-1,3-Dioxolane"	CC1COC(C)O1	"grassy, fruity, green"
Ofloxacin	CC1COc2c(N3CCN(C)CC3)c(F)cc4C(=O)C(=CN1c24)C(O)=O	bitter
3-Methylfuran	Cc1cocc1	None
4-Methylthiazole	Cc1cscn1	"vegetable, tomato, nutty, roasted meat, green"
"2,3,5,6-Tetramethylpyrazine"	Cc1nc(C)c(C)nc1C	"chocolate, burnt, lard, musty, coffee, cocoa, soybean, nutty"
Thialdine	CC1NC(C)SC(C)S1	"beefy, roasted, meaty"
"2-Methyl-5,7-Dihydrothieno[3,4-D]Pyrimidine"	Cc1ncc2CSCc2n1	"taco, roasted, toasted, popcorn, corn, chip"
"2,3-Dimethylpyrazine"	Cc1nccnc1C	"butter, caramel, nut, peanut butter, meat, leather, coffee, cocoa, peanut, nutty, almond, walnut"
2-Furfurylthio-3-Methylpyrazine	Cc1nccnc1SCc2occc2	None
4-Methyl-5-Vinylthiazole	Cc1ncsc1C=C	"vegetable, musty, cocoa, root, nutty"
4-Methyl-5-Thiazoleethanol	Cc1ncsc1CCO	"sulfur, cooked beef juice, fatty"
Sulfisoxazole	Cc1noc(N[S](=O)(=O)c2ccc(N)cc2)c1C	bitter
3658-77-3	CC1OC(=C(O)C1=O)C	"caramel, strawberry, grape, cotton, sweet, sugar, candy, almond"
4166-20-5	CC1OC(=C(OC(C)=O)C1=O)C	"brown, molasses, caramel, toffee, bread, sweet, sugar, fruity, tropical, baked"
14400-67-0	CC1OC(=CC1=O)C	"caramel, ester, fruity"
28664-35-9	CC1OC(=O)C(=C1C)O	"maple, caramel, cotton candy, tobacco, spice, burnt, smoky, fennel, coffee, sugar, extremely sweet, celery, strong, seedy"
5-Methyl-2(5H)-Furanone	CC1OC(=O)C=C1	"solvent, tobacco, coumarin, oily, sweet, nutty, tonka"
"2,4,5-Trimethyl-3-Oxazoline"	CC1OC(C)C(=N1)C	"caramel, musty, wood, nutty, green"
"2,4,5-Trimethyloxazole"	Cc1oc(C)c(C)n1	"wasabi, roasted, mustard, shellfish, vegetable, nut skin, nutty"
"2,5-Dimethylfuran-3-Thiol"	Cc1oc(C)c(S)c1	"sulfurous, meat, lamb, meaty"
"S-(2,5-Dimethyl-3-Furanyl) 2-Furancarbothioate"	Cc1oc(C)c(SC(=O)c2occc2)c1	vegetable
"2,5-Dimethylfuran"	Cc1oc(C)cc1	"roast, ethereal, bacon, chemical, gravy, beef, meaty"
Paraldehyde	CC1OC(C)OC(C)O1	"sweet, aromatic"
5-Methylfurfural	Cc1oc(C=O)cc1	"caramel, spice, burnt sugar, maple, almond"
Lanatoside C	CC1OC(CC(O)C1OC2CC(O)C(OC3CC(OC(C)=O)C(OC4OC(CO)C(O)C(O)C4O)C(C)O3)C(C)O2)OC5CCC6(C)C(CCC7C6CC(O)C8(C)C(CCC78O)C9=CC(=O)OC9)C5	"fatty, metallic"
6-Deoxyhexopyranose	CC1OC(O)C(O)C(O)C1O	sweet
Wistariasaponin G	CC1OC(OC2C(O)C(O)OCC2OC3C(O)C(O)C(OC3OC4CCC5(C)C(CCC6(C)C5CC=C7C8CC(C)(CC(OC(C)=O)C8(C)CCC67C)C(O)=O)C4(C)CO)C(O)=O)C(O)C(O)C1O	sweet-like
Astilbin	CC1OC(OC2C(Oc3cc(O)cc(O)c3C2=O)c4ccc(O)c(O)c4)C(O)C(O)C1O	sweet-like
2-Methylbenzoxazole	Cc1oc2ccccc2n1	"tobacco, burnt, powdery, capers, meaty, phenolic"
"2,4-Dimethyl-3-Oxazoline"	CC1OCC(=N1)C	boiled beef
2-Methylfuran	Cc1occc1	"ethereal, acetone, chocolate"
2-Methyltetrahydrofuran-3-One	CC1OCCC1=O	"solvent, bread, buttery, sweet, nutty"
38325-25-6	CC1OCCC12SC3CCOC3(C)S2	meaty
2-Methyl-3-Furanthiol	Cc1occc1S	"coconut, meat, sulfury, fishy, metallic, meaty"
2-Methyl-3-Tetrahydrofuranthiol	CC1OCCC1S	"sulfurous, roasted, meat, chicken, beef"
Sulfamethoxazole	Cc1onc(N[S](=O)(=O)c2ccc(N)cc2)c1	bitter
"2,4,5-Trimethylthiazole"	Cc1sc(C)c(C)n1	"hazelnut, chocolate, vegetable, musty, coffee, cocoa, earth, nutty"
"2,5-Dimethylthiophene"	Cc1sc(C)cc1	"nutty, sulfury"
"2,5-Dimethylthiazole"	Cc1sc(C)nc1	"nutty, roasted"
"2,4-Dimethylthiazole"	Cc1scc(C)n1	"rubber, beefy, mold, roasted, barley, coffee, tea"
2-Methylthiophene	Cc1sccc1	"sulfur, sulfurous, roasted, onion, alliaceous, green"
2-Methylthiophene-3-Thiol	Cc1sccc1S	"medicine, medicinal"
"2-Methyl-1,3-Dithiolane"	CC1SCCS1	"sulfur, sulfurous, smoky, vegetable, savory, alliaceous"
"3-Methyl-1,2,4-Trithiane"	CC1SCCSS1	None
"4,5-Dimethylthiazole"	Cc1scnc1C	"roast, roasted, boiled shrimp, green, fishy, nutty, smoke"
"3,5-Dimethyl-1,2,4-Trithiolane"	CC1SSC(C)S1	"beefy, sulfurous, meaty"
(E)-.Beta.-Farnesene	CCC(=C)CC\C=C(/C)CCC=C(C)C	"citrus, green"
"3,4-Hexanedione"	CCC(=O)C(=O)CC	"caramel, toasted, buttery, nutty, almond"
"2,3-Pentanedione"	CCC(=O)C(C)=O	"butter, cream, caramel, sweet, pungent, creamy, nutty, cheese"
2-Methyl-3-Pentanone	CCC(=O)C(C)C	mint
Methadone	CCC(=O)C(CC(C)N(C)C)(c1ccccc1)c2ccccc2	bitter
2-Oxobutanoic Acid	CCC(=O)C(O)=O	"brown, caramel, lactonic, sweet, creamy"
Ethyl Vinyl Ketone	CCC(=O)C=C	"peppery, mustard, garlic, onion, fish, pungent"
2-Propionylpyrrole	CCC(=O)c1[nH]ccc1	"roast, popcorn"
Propiophenone	CCC(=O)c1ccccc1	"lilac, hawthorn"
1-(2-Thienyl)-1-Propanone	CCC(=O)c1sccc1	"caramel, creamy"
2-Propionylthiazole	CCC(=O)c1sccn1	"nutty, popcorn, cereal, bread"
3-Pentanone	CCC(=O)CC	"ethereal, acetone, ether"
1-(Methylthio)-2-Butanone	CCC(=O)CSC	"oily, garlic, mushroom, fishy"
Fentanyl Citrate	CCC(=O)N(C1CCN(CC1)CCc2ccccc2)c3ccccc3.OC(=O)CC(O)(CC(O)=O)C(O)=O	bitter
Methyl Propionate	CCC(=O)OC	"harsh, apple, strawberry, fresh, rum, fruity"
Linalyl Propionate	CCC(=O)OC(C)(CCC=C(C)C)C=C	"rose, fresh, woody, lily, rum, bergamot"
Isopropyl Propionate	CCC(=O)OC(C)C	"banana, sweet, ether, pineapple, bitter, fruity"
1-Phenylethyl Propionate	CCC(=O)OC(C)c1ccccc1	"gardenia, rose, fresh, floral, sweet, weedy, green"
Sorbyl Propionate	CCC(=O)OC\C=C\C=C\C	None
Maltol Propionate	CCC(=O)OC1=C(C)OC=CC1=O	"bready, berry, jammy, strawberry, sweet, caramellic"
Carvyl Propionate	CCC(=O)OC1CC(CC=C1C)C(C)=C	"minty, sweet, fruity, warm"
2-Bornyl Propionate	CCC(=O)OC1CC2CCC1(C)C2(C)C	"turpentine, fruit, woody, pungent, lavender, pine, camphor"
Cyclohexyl Propionate	CCC(=O)OC1CCCCC1	"pineapple, banana, waxy, sweet, fruity, green"
Cyclopentenyl Propionate Musk	CCC(=O)OCC(C)(C)CC1=C(C)CCC1C(C)=C	musky
Isobutyl Propionate	CCC(=O)OCC(C)C	"banana, tutti frutti, sweet, fruity, green, bitter, ether"
Tripropionin	CCC(=O)OCC(COC(=O)CC)OC(=O)CC	"chemical, bitter, oily"
Allyl Propionate	CCC(=O)OCC=C	"apple, apricot, ripe, tropical, fruity"
Anisyl Propionate	CCC(=O)OCc1ccc(OC)cc1	"peach, vanilla, anisic, herbal, fruity, cherry"
Benzyl Propionate	CCC(=O)OCc1ccccc1	"apple, berry, jasmine, jam, jasmin, banana, strawberry, floral, sweet, fruity, balsam"
Tetrahydrofurfuryl Propionate	CCC(=O)OCC1CCCO1	"paint, oily, fruity, tropical, leaf, violet"
Furfuryl Propionate	CCC(=O)OCc1occc1	"banana, oily, coffee, sweet, fruity, spicy, green"
Isoamyl Propionate	CCC(=O)OCCC(C)C	"tomato, ripe, sweet, fruity, tropical, fruit, pineapple, bitter, banana"
Citronellyl Propionate	CCC(=O)OCCC(C)CCC=C(C)C	"neroli, waxy, rose, green, floral, bitter, fruity"
Rhodinyl Propionate	CCC(=O)OCCC(C)CCCC(C)=C	"geranium, rose, verbena"
2-Phenylethyl Propionate	CCC(=O)OCCc1ccccc1	"red rose, floral, fruity, balsam, honey, styrax"
3-Phenylpropyl Propionate	CCC(=O)OCCCc1ccccc1	"floral, mimosa, hyacinth, balsam"
S-Allyl Thiopropionate	CCC(=O)SCC=C	"garlic, onion, fresh, sweet, gassy, green"
S-Furfuryl Thiopropionate	CCC(=O)SCc1occc1	"sulfurous, garlic, onion, savory, coffee"
Acecarbromal	CCC(Br)(CC)C(=O)NC(=O)NC(C)=O	bitter
Neuronal	CCC(Br)(CC)C(N)=O	bitter
Sulfonethylmethane	CCC(C)([S](=O)(=O)CC)[S](=O)(=O)CC	bitter
"5-(2-Methylbutan-2-Yl)-5-(Prop-2-En-1-Yl)Pyrimidine-2,4,6(1h,3h,5h)-Trione"	CCC(C)(C)C1(CC=C)C(=O)NC(=O)NC1=O	bitter
Coniferan	CCC(C)(C)C1CCCCC1OC(C)=O	"fir, jam, woody, sweet, balsam, raspberry"
2-Methyl-2-Butanol	CCC(C)(C)O	pungent
3-Methyl-3-Pentanol	CCC(C)(O)CC	"leafy, powerful, fruity, green"
3-Methyl-1-Phenyl-3-Pentanol	CCC(C)(O)CCc1ccccc1	"anisic, lilac, peony, fresh, narcissus, earthy, sweet, cayloxol"
Tetrahydrolinalool	CCC(C)(O)CCCC(C)C	"lilac, floral, oily, lily, woody, tea, bois de rose"
2-Butanone	CCC(C)=O	"ethereal, ether, fruity, acetone, camphor"
3-Methyl-2-Oxovaleric Acid	CCC(C)C(=O)C(O)=O	None
Methyl 2-Methylbutyrate	CCC(C)C(=O)OC	"apple, tutti frutti, fatty, sweet, fruity, green"
Mentyl Isovalerate	CCC(C)C(=O)OC1CC(C)CCC1C(C)C	bitter
S-Methyl 2-Methylbutanethioate	CCC(C)C(=O)SC	None
Dl-Isoleucine	CCC(C)C(N)C(O)=O	"odorless, sweet"
2-Methylbutanoic Acid	CCC(C)C(O)=O	"sour, sweat, acid, strawberry, roquefort cheese, pungent, cheese"
2-Methylbutyraldehyde	CCC(C)C=O	"musty, coffee, cocoa, nutty, almond"
Butallylonal	CCC(C)C1(CC(Br)=C)C(=O)NC(=O)NC1=O	bitter
Talbutal	CCC(C)C1(CC=C)C(=O)NC(=O)NC1=O	bitter
2-Sec-Butylcyclohexanone	CCC(C)C1CCCCC1=O	"mint, vanilla, fresh, peppermint, musty, woody, minty, camphor"
3-Methylvaleric Acid	CCC(C)CC(O)=O	"cheesy, sweaty, acidic, sharp, animal, fruity, green"
Phytane	CCC(C)CCCC(C)CCCC(C)CCCC(C)C	None
4-Methyl-1-Hexanol	CCC(C)CCCO	sweat
3-Methyl-1-Pentanol	CCC(C)CCO	"wine, fusel, cocoa, fruity, cognac, green"
2-Methylbutylamine	CCC(C)CN	fishy
2-Methyl-1-Butanol	CCC(C)CO	"roasted, onion, malt, wine, fruity"
2-METHYLBUTYL 2-METHYLBUTYRATE	CCC(C)COC(=O)C(C)CC	"apple, berry, waxy, ester, sweet, fruity, green"
2-Methylbutyl 3-Methylbutenoate	CCC(C)COC(=O)C=C(C)C	"floral, fruity"
2-Methylbutyl Isovalerate	CCC(C)COC(=O)CC(C)C	"apple, herbal, green, earthy, fruity, soapy, cheese"
2-Methylbutyl Acetate	CCC(C)COC(C)=O	"overripe fruit, banana, fruit, sweet, peanut, juicy"
2-Methyl-1-Butanethiol	CCC(C)CS	"bloody, sulfurous, meaty"
Sec-Butylamine	CCC(C)N	"ammonia, fishy"
Sec-Butyl Isothiocyanate	CCC(C)N=C=S	None
2-Butanol	CCC(C)O	"oily, sweet, wine, apricot"
Sec-Butyl Disulfide	CCC(C)SSC(C)CC	None
Allyl 2-Ethylbutyrate	CCC(CC)C(=O)OCC=C	"peach-pit, nut, ethereal, oily, fruit, cherry-pit"
2-Ethylbutyric Acid	CCC(CC)C(O)=O	"sour, caramel, berry, acidic, whiskey, fruity, dry"
2-Ethylbutanal	CCC(CC)C=O	"ethereal, cocoa, sweet, fruity, green"
2-Ethylbutyl Acetate	CCC(CC)COC(C)=O	"apricot, ethereal, banana, oily, musty, sweet, fruity"
Propionic Acid	CCC(O)=O	"cheesy, soy, acidic, vinegar, rancid, pungent"
Terpinyl Propionate	CCC(O)=O.CC1(C)C2CCC(C)(C1C2)C3(C)CCC4CC3(C4(C)C)C5(C)CCC6CC5C6(C)C	"citrus, geranium, tropical, old wood, green, herbal, bitter"
3-Hydroxy-2-Pentanone	CCC(O)C(C)=O	"truffle, herbal, herb"
1-Penten-3-Ol	CCC(O)C=C	"butter, pungent, tropical, horseradish, green, vegetable, bitter, fruity"
1-Phenyl-1-Propanol	CCC(O)c1ccccc1	"floral, sweet, balsam"
3-Pentanol	CCC(O)CC	"herbal, oily, fruit, sweet, nutty"
3-Mercapto-2-Pentanone	CCC(S)C(C)=O	"sulfur, sulfurous, roasted, potato, onion, meat, horseradish, metallic"
"1,2-Butanedithiol"	CCC(S)CS	"sulfur, meat, roasted"
Clindamycin	CCC[C@@H]1C[C@H](N(C)C1)C(=O)NC(C(C)Cl)[C@H]2O[C@H](SC)[C@H](O)[C@@H](O)[C@H]2O	bitter
"3,6-Nonadien-1-Ol"	CCC=CCC=CCCO	None
"2,6-Nonadien-1-Ol"	CCC=CCCC=CCO	"vegetable, green, cucumber"
Propionaldehyde	CCC=O	"solvent, alcohol, whiskey, wine, earthy, cocoa, pungent, nutty"
Cyclobarbital	CCC1(C(=O)NC(=O)NC1=O)C2=CCCCC2	bitter
Heptabarbital	CCC1(C(=O)NC(=O)NC1=O)C2=CCCCCC2	bitter
"5-Ethyl-3,4,5,6-Tetramethyl-2-Cyclohexen-1-One"	CCC1(C)C(C)C(=CC(=O)C1C)C	None
Piperidione	CCC1(CC)C(=O)CCNC1=O	bitter
Barbital	CCC1(CC)C(=O)NC(=O)NC1=O	bitter
Methyprylon	CCC1(CC)C(=O)NCC(C)C1=O	bitter
Amobarbital	CCC1(CCC(C)C)C(=O)NC(=O)NC1=O	bitter
2-Ethylfenchol	CCC1(O)C(C)(C)C2CCC1(C)C2	"lime, berry, rooty, damp, earthy, musty, ground, camphor"
20189-42-8	CCC1=C(C)C(=O)NC1=O	None
Glimepiride	CCC1=C(C)CN(C(=O)NCCc2ccc(cc2)[S](=O)(=O)NC(=O)NC3CCC(C)CC3)C1=O	bitter
27538-09-6	CCC1=C(O)C(=O)C(C)O1	"bready, brown, caramel, burnt, cotton candy, sweet, sugar, maple"
Ethyl Maltol	CCC1=C(O)C(=O)C=CO1	"sweet, candy, strawberry, jam, caramel, bitter, cotton"
21835-01-8	CCC1=C(O)C(=O)CC1	"butterscotch, chocolate, caramel, smoky, sweet, maple, fenugreek"
5-Ethyl-2-Hydroxy-3-Methylcyclopent-2-En-1-One	CCC1CC(=C(O)C1=O)C	None
4-Ethylsyringol	CCc1cc(OC)c(O)c(OC)c1	None
Versalide	CCc1cc2c(cc1C(C)=O)C(C)(C)CCC2(C)C	musky
Gamma-Caprolactone	CCC1CCC(=O)O1	"coconut, tobacco, coumarin, herbal, sweet"
5-Ethyl-2-Methylpyridine	CCc1ccc(C)nc1	"raw, roasted, potato, earthy, strong, nutty"
4-Ethylbenzaldehyde	CCc1ccc(C=O)cc1	"sweet, almond, bitter"
"2,5-Diethyltetrahydrofuran"	CCC1CCC(CC)O1	"caramel, sweet, herbal"
4-Ethyl-2-Methoxyphenol	CCc1ccc(O)c(OC)c1	"spice, smoky, clove, bacon, spicy, phenolic"
4-Ethylphenol	CCc1ccc(O)cc1	"smoke, castoreum, spice, alcohol, guaiacol, phenol, medicinal, phenolic"
"4-Ethyl-1,2-Dimethoxybenzene"	CCc1ccc(OC)c(OC)c1	"musty, earthy"
2-Ethylcyclobutanol	CCC1CCC1O	None
3-Ethyl-O-Xylene	CCc1cccc(C)c1C	None
3-Ethylphenol	CCc1cccc(O)c1	"must, musty"
Ethylbenzene	CCc1ccccc1	None
Ethylcyclohexane	CCC1CCCCC1	None
2-Ethylpyridine	CCc1ccccn1	"grassy, grass, green"
3-Ethylpyridine	CCc1cccnc1	"caramel, citrus, tobacco, wine_like, smoky, vegetable, leather, oakmoss, fatty, floral, musty, woody, earthy, fruity, peanut, herbaceous, nutty, meaty, spicy, green"
"5-Ethyl-2,3-Dimethylpyrazine"	CCc1cnc(C)c(C)n1	"burnt, popcorn"
"3,5-Diethyl-2-Methylpyrazine"	CCc1cnc(C)c(CC)n1	"nutty, vegetable, meaty, baked"
2-Ethyl-5-Methylpyrazine	CCc1cnc(C)cn1	"bean, fruit, sweet, coffee"
"2,5-Diethyl-3-Methylpyrazine"	CCc1cnc(CC)c(C)n1	"hazelnut, toasted, meaty"
2-Ethyl-6-Methylpyrazine	CCc1cncc(C)n1	"potato, roasted"
2-Ethylpyrazine	CCc1cnccn1	"butter, peanut, musty, cocoa, nutty, wood, roasted, woody, bitter, peanut butter"
"3-Ethyl-2,5-Dimethylpyrazine"	CCc1nc(C)cnc1C	"roast, roasted, potato, cocoa, nutty"
"2,5-Dimethyl-4-Ethyloxazole"	CCc1nc(C)oc1C	"burnt, roasted"
"2-Ethyl-3,5-Dimethylpyrazine"	CCc1ncc(C)nc1C	"roast, burnt almonds, roasted nuts, potato, coffee"
"2,3-Diethyl-5-Methylpyrazine"	CCc1ncc(C)nc1CC	"roast, citrus, hazelnut, roasted, wine_like, potato, vegetable, meat, fatty, floral, earthy, woody, musty, fruity, herbaceous, nutty, meaty, spicy, green"
2-Ethyl-3-Methylpyrazine	CCc1nccnc1C	"raw, hazelnut, roast, sweat, potato, bread, musty, earthy, peanut, nutty, corn"
2-Acetyl-3-Ethylpyrazine	CCc1nccnc1C(C)=O	"potato, tomato, oily, earthy, nutty, popcorn, corn, chip"
"2,3-Diethylpyrazine"	CCc1nccnc1CC	"raw, hazelnut, pepper, nutty, green"
2-Ethyl-3-Methoxypyrazine	CCc1nccnc1OC	"raw, potato, pepper, earthy, bell, nutty"
2-Ethyl-4-Hydroxy-5-Methyl-3(2H)-Furanone	CCC1OC(=C(O)C1=O)C	"butterscotch, caramel, sweet, candy"
698-10-2	CCC1OC(=O)C(=C1C)O	"caramel, spice, sweet, fruity, maple"
5-Ethyl-2(5H)-Furanone	CCC1OC(=O)C=C1	spice
"2-Ethyl-4,5-Dimethyloxazole"	CCc1oc(C)c(C)n1	"vegetable, earthy, creamy, green"
2-Ethylfuran	CCc1occc1	"earthy, sweet, burnt, malty"
"2,5-Diethylthiazole"	CCc1sc(CC)nc1	"musty, nutty, meaty"
2-Ethyl-4-Methylthiazole	CCc1scc(C)n1	"nutty, pistachio, green"
2-Ethylthiazole	CCc1sccn1	"nutty, green"
5-Ethyl-4-Methylthiazole	CCc1scnc1C	"earthy, nut, green"
"2,3-Hexanedione"	CCCC(=O)C(C)=O	"butter, caramel, oily, fatty, sweet, creamy, fruity, phenolic, dry"
61295-41-8	CCCC(=O)C(CC)Sc1ccoc1C	"roasted, meaty"
1-Hexen-3-One	CCCC(=O)C=C	"vegetable, cooked vegetable, metal, metallic, cooked"
Butyrophenone	CCCC(=O)c1ccccc1	cherry
1-(2-Thienyl)-1-Butanone	CCCC(=O)c1sccc1	"roast, grilled, beef"
3-Hexanone	CCCC(=O)CC	"ether, waxy, grape, sweet, rum, fruity"
4-Heptanone	CCCC(=O)CCC	"pineapple, strawberry, sweet, fruity, peanut, cognac, cheese"
Methyl Butyrate	CCCC(=O)OC	"apple, pineapple, ether, banana, fruit, sweet, fruity"
Methionyl Butyrate	CCCC(=O)OC(=O)[C@@H](N)CCSC	"cabbage, sulfurous"
Butyric Anhydride	CCCC(=O)OC(=O)CCC	butter
10094-34-5	CCCC(=O)OC(C)(C)Cc1ccccc1	"prune, herbal, floral, plum, fruity, green"
Linalyl Butyrate	CCCC(=O)OC(C)(CCC=C(C)C)C=C	"berry, banana, sweet, fruity, bergamot, pear"
Isopropyl Butyrate	CCCC(=O)OC(C)C	"pineapple, ether, ripe, fruit, sweet, pungent, fruity, estery"
1-Phenylpropyl Butyrate	CCCC(=O)OC(CC)c1ccccc1	"apricot, jasmin, floral, plum, fruity"
103-61-7	CCCC(=O)OC/C=C/c1ccccc1	None
Sorbyl Butyrate	CCCC(=O)OC\C=C\C=C\C	None
Bornyl Butyrate	CCCC(=O)OC1CC2CCC1(C)C2(C)C	"wood, woody, herbal, herb"
Phenyl Butyrate	CCCC(=O)Oc1ccccc1	"floral, sweet"
Ethyl Butyrate	CCCC(=O)OCC	"apple, pineapple, banana, fruit, fruity, juicy, cognac"
Isobutyl Butyrate	CCCC(=O)OCC(C)C	"apple, berry, pineapple, sweet, rum, fruity"
Tributyrin	CCCC(=O)OCC(COC(=O)CCC)OC(=O)CCC	"waxy, bitter, fatty, cheese, creamy"
Allyl Butyrate	CCCC(=O)OCC=C	"peach, pineapple, apricot, waxy, sweet, pungent, fruity, tropical, green"
Benzyl Butyrate	CCCC(=O)OCc1ccccc1	"peach, butter, berry, jasmine, apricot, jasmin, fresh, logenberry, plum, fruity, pear, cheese"
Furfuryl Butyrate	CCCC(=O)OCc1occc1	"fruity, grape, green"
Isoamyl Butyrate	CCCC(=O)OCCC(C)C	"hop_oil, apricot, whiskey, banana, tropica, papaya, melon, fruity, pear, green"
Citronellyl Butyrate	CCCC(=O)OCCC(C)CCC=C(C)C	"rose, waxy, floral, fruit, sweet, fruity, tropical, geranium, green"
Rhodinyl Butyrate	CCCC(=O)OCCC(C)CCC=C(C)C	"berry, red rose, tropical, fruity, geranium"
Phenethyl Butyrate	CCCC(=O)OCCc1ccccc1	"yeast, strawberry, floral, musty, sweet"
S-Methyl Thiobutyrate	CCCC(=O)SC	"cabbage, putrid, garlic, sulfury, animal, cheese"
2-Methyl-2-Pentanol	CCCC(C)(C)O	pungent
Carisoprodol	CCCC(C)(COC(N)=O)COC(=O)NC(C)C	bitter
Meprobamate	CCCC(C)(COC(N)=O)COC(N)=O	bitter
2-Pentanone	CCCC(C)=O	"potato, alcohol, ether, ethereal, wine, banana, fishy, fruit, sweet, woody, fruity"
Ethyl 2-Methylpentanoate	CCCC(C)C(=O)OCC	"pineapple, apple skin, fresh, waxy, melon, fruity, natural, green"
3-Methylhexan-2-Ol	CCCC(C)C(C)O	None
2-Methylpentanoic Acid	CCCC(C)C(O)=O	"sour, cheese"
2-Methylpentanal	CCCC(C)C=O	"ethereal, fruity, green"
3-Methylhexanal	CCCC(C)CC=O	None
3-Methyl-1-Hexanol	CCCC(C)CCO	None
2-Pentanol	CCCC(C)O	"oil, fermented, mild, fusel, green"
2-Pentyl Butyrate	CCCC(C)OC(=O)CCC	"apricot, herbal, banana, cashew, sweet, fruity"
2-Pentyl Acetate	CCCC(C)OC(C)=O	"herbal, tropical"
2-Pentanethiol	CCCC(C)S	"gassy, sulfury"
Valpromide	CCCC(CCC)C(N)=O	bitter
3-(Methylthio)-1-Hexanol	CCCC(CCO)SC	"leafy, sulfurous, pepper, vegetable, melon, metallic, green"
3-(Methylthio)Hexyl Acetate	CCCC(CCOC(C)=O)SC	"vegetable, sulfury, tropical, spicy, green"
Butyramide	CCCC(N)=O	nutty
Butyric Acid	CCCC(O)=O	"butter, sweat, acetic, sharp, rancid, fruit, cheese"
1-Hexen-3-Ol	CCCC(O)C=C	"ethereal, rum, green"
3-Hexanol	CCCC(O)CC	"alcoholic, alcohol, ether, medicinal"
Ethyl 3-Hydroxyhexanoate	CCCC(O)CC(=O)OCC	"citrus, pineapple, smoky, grape, fresh, fruity"
1-Phenyl-2-Pentanol	CCCC(O)Cc1ccccc1	"earthy, sweet, green, mild"
Oct-4-En-3-One	CCCC=CC(=O)CC	None
"1,1-Diethoxyhex-2-Ene"	CCCC=CC(OCC)OCC	None
Octadienal	CCCC=CC=CC=O	None
Hept-3-Enyl Isobutyrate	CCCC=CCCOC(=O)C(C)C	None
Butyraldehyde	CCCC=O	"bready, chocolate, creamy, pear, vegetable, fatty, earthy, woody, pungent, nutty, wine_like, meaty, spicy, citrus, herbaceous, green, apple, floral, musty, cocoa, fruity, malty"
Gamma-Heptalactone	CCCC1CCC(=O)O1	"coconut, caramel, nut, fat, hay, fruit, sweet, nutty, tonka"
2-Methoxy-4-Propylphenol	CCCc1ccc(O)c(OC)c1	"powdery, allspice, clove, pepper, sharp, fishy, phenol, sweet, anise, balsam, soapy, spicy, phenolic"
4-Propylphenol	CCCc1ccc(O)cc1	"medicinal, phenolic"
4-Propylanisole	CCCc1ccc(OC)cc1	"licorice, fennel, sassafrass, sweet, anise"
1-Methyl-3-Propylbenzene	CCCc1cccc(C)c1	None
Propylbenzene	CCCc1ccccc1	None
2-Propylphenol	CCCc1ccccc1O	"smoky, medicinal, phenolic"
2-Propylpyridine	CCCc1ccccn1	"tobacco, roasted, fatty, nutty, green"
"2-Methyl-4-Propyl-1,3-Oxathiane"	CCCC1CCOC(C)S1	"pineapple, tropica, tropical, galbanum, green"
2-Propylpyrazine	CCCc1cnccn1	"nutty, vegetable, green"
"2,5-Dimethyl-3-Propylpyrazine"	CCCc1nc(C)cnc1C	hazelnut
"3,5-Dimethyl-2-Propylpyrazine"	CCCc1ncc(C)nc1C	"hazelnut, burnt"
2-Methyl-3-Propylpyrazine	CCCc1nccnc1C	nutty
"4,5-Dimethyl-2-Propyloxazole"	CCCc1oc(C)c(C)n1	"burnt, roasted"
Pentane	CCCCC	alkane
"2,3-Heptanedione"	CCCCC(=O)C(C)=O	"oily, butter, cheese"
2-Methyl-3-Heptanone	CCCCC(=O)C(C)C	"leafy, fruity, green"
61295-50-9	CCCCC(=O)C(CCC)Sc1ccoc1C	"roasted, meaty"
Valerophenone	CCCCC(=O)c1ccccc1	"balsam, valerian"
3-Heptanone	CCCCC(=O)CC	"fatty, powerful, fruity, green"
5-Nonanone	CCCCC(=O)CCCC	None
Methyl Valerate	CCCCC(=O)OC	"apple, pineapple, sweet, fruity, nutty, green"
Linalyl Valerate	CCCCC(=O)OC(C)(CCC=C(C)C)C=C	"citrus, lavender, fruity, apricot"
Menthyl Valerate	CCCCC(=O)OC1CC(C)CCC1C(C)C	None
Bornyl Valerate	CCCCC(=O)OC1CC2CCC1(C)C2(C)C	"berry, spice, vanilla, sawdust, woody, camphor, oak, seedy"
Ethyl Pentanoate	CCCCC(=O)OCC	"yeast, apple, pineapple, fruit, sweet, fruity, tropical, green"
Allyl Valerate	CCCCC(=O)OCC=C	pineapple
Furan-2-Ylmethyl Pentanoate	CCCCC(=O)OCc1occc1	"apple, cheesy, pineapple, sweet, tropical, fruity"
Propyl Pentanoate	CCCCC(=O)OCCC	"pineapple, ethereal, animal, fruity, metallic"
Isopentyl Valerate	CCCCC(=O)OCCC(C)C	"apple, ripe"
Citronellyl Valerate	CCCCC(=O)OCCC(C)CCC=C(C)C	"warm, rose, herbal, honey, herb"
2-Phenylethyl Pentanoate	CCCCC(=O)OCCc1ccccc1	"rose, fruity, leaf"
2-Hexanone	CCCCC(C)=O	"ethereal, ether"
2-Methylhexanoic Acid	CCCCC(C)C(O)=O	"lard, oily, fatty, fruity, cheese"
4-Methyloctanoic Acid	CCCCC(C)CCC(O)=O	"waxy, fatty, musty, creamy, dairy, mossy, milk, plastic"
2-Hexanol	CCCCC(C)O	"chemical, winey"
Ethyl 2-Ethylhexanoate	CCCCC(CC)C(=O)OCC	"herbal, fresh, fruity, orris, cumin"
4-Ethyloctanoic Acid	CCCCC(CC)CCC(O)=O	None
2-Ethylhexan-1-Ol	CCCCC(CC)CO	"citrus, rose, fresh, floral, oily, sweet, green"
Docusate Hydrogen	CCCCC(CC)COC(=O)CC(C(=O)OCC(CC)CCCC)[S](O)(=O)=O	"burnt, powdery, anisic, coumarinic, sweet, honey, hawthorn, nutty, phenolic"
2-Ethyl-1-Hexanethiol	CCCCC(CC)CS	None
DL-Norleucine	CCCCC(N)C(O)=O	bitter
N-Formyl-Nle-Leu-Phe	CCCCC(NC=O)C(=O)NC(CC(C)C)C(=O)NC(Cc1ccccc1)C(O)=O	sweet
Valeric Acid	CCCCC(O)=O	"sweat, putrid, sweaty, acidic, animal, rancid, sickening"
Terpinyl Valerate	CCCCC(O)=O.CC1(C)C2CCC(C)(C1C2)C3(C)CCC4CC3(C4(C)C)C5(C)CCC6CC5C6(C)C	"floral, fruity"
1-Hepten-3-Ol	CCCCC(O)C=C	"acrylate, tomato, oily, metallic, spicy, green"
3-Heptanol	CCCCC(O)CC	"herbal, powerful, bitter, herb"
122-40-7	CCCCC/C(C=O)=C/c1ccccc1	None
Pentanal	CCCCC=O	"bready, fermented, berry, malt, pungent, fruity, nutty, almond"
Butethal	CCCCC1(CC)C(=O)NC(=O)NC1=O	bitter
Suxibuzone	CCCCC1(COC(=O)CCC(O)=O)C(=O)N(N(C1=O)c2ccccc2)c3ccccc3	bitter
104-50-7	CCCCC1CCC(=O)O1	"coconut, waxy, fatty, sweet, creamy, dairy, tonka"
Delta-Octanolactone	CCCCC1CCC(=O)O1	"peach, coconut, fatty, sweet, tropical, dairy, tonka"
Delta-Nonalactone	CCCCC1CCCC(=O)O1	"coconut, coumarin, milky, creamy, sweet"
Butylhydroxyanisole	CCCCc1cccc(OC)c1O	"rubbery, mild"
Epsilon-Decalactone	CCCCC1CCCCC(=O)O1	"sweet, creamy, tonka"
4-Butyl-5-Methylthiazole	CCCCc1ncsc1C	"bell, pepper, green"
Butylphthalide	CCCCC1OC(=O)c2ccccc12	"herbal, celery"
Whiskey Lactone	CCCCC1OC(=O)CC1C	"coconut, burnt, coumarin, toasted, celery, nutty, tonka"
"2-Butyl-4-Methyl-1,3-Dioxolane"	CCCCC1OCC(C)O1	"fatty, nutty"
2-Butylfuran	CCCCc1occc1	"mild, wine, sweet, fruity, spicy"
Hexane	CCCCCC	alkane
Methyl 2-Octynoate	CCCCCC#CC(=O)OC	"leafy, waxy, green, violet, cucumber"
3-Methylideneoctan-2-One	CCCCCC(=C)C(C)=O	"musty, mushroom"
"Octane-2,3-Dione"	CCCCCC(=O)C(C)=O	"dill, buttery, broccoli, cooked"
1-Octen-3-One	CCCCCC(=O)C=C	"herbal, earthy, metal, musty, mushroom, dirty"
2-Hexanoylfuran	CCCCCC(=O)c1occc1	"peach, apricot, ketone, sweet, fruity, green"
6-Undecanone	CCCCCC(=O)CCCCC	None
Methyl Hexanoate	CCCCCC(=O)OC	"pineapple, ether, fresh, fruit, sweet, fruity"
Isopropyl Hexanoate	CCCCCC(=O)OC(C)C	"berry, pineapple, fresh, logenberry, fruity"
Ethyl Caproate	CCCCCC(=O)OCC	"pineapple, apple peel, waxy, banana, fruit, sweet, fruity, green"
Isobutyl Hexanoate	CCCCCC(=O)OCC(C)C	"peach, pineapple, sweet, fruity, tropical, green"
Allyl Hexanoate	CCCCCC(=O)OCC=C	"pineapple, ethereal, arrack, fatty, sweet, rum, fruity, tropical, cognac"
Benzyl Hexanoate	CCCCCC(=O)OCc1ccccc1	"apricot, gardenia, jasmin, fruity, green"
Propyl Hexanoate	CCCCCC(=O)OCCC	"pineapple, fruit, sweet, fruity, tropical, juicy, green"
Isopentyl Hexanoate	CCCCCC(=O)OCCC(C)C	"apple, pineapple, banana, fruity, green"
Citronellyl Hexanoate	CCCCCC(=O)OCCC(C)CCC=C(C)C	"floral, rose, fruity, fine"
2-Phenylethyl Hexanoate	CCCCCC(=O)OCCc1ccccc1	"pineapple, sweaty, waxy, banana, floral, woody, sweet, honey, green"
Butyl Hexanoate	CCCCCC(=O)OCCCC	"berry, pineapple, wine, fruit, fruity"
S-Methyl Hexanethioate	CCCCCC(=O)SC	"ethereal, tropical, fruity, green"
2-Heptanone	CCCCCC(C)=O	"coconut, soap, herbal, sweet, woody, fruity, spicy, cinnamon"
2-Methylheptanoic Acid	CCCCCC(C)C(O)=O	"butter, sweaty, waxy, green, milk, cheese"
2-Heptanol	CCCCCC(C)O	"lemon, mushroom, sweet, floral, green, herbal, fresh, grass, bitter, fruity"
Octan-3-Yl Butanoate	CCCCCC(CC)OC(=O)CCC	"citrus, herbal, musty, fruity, green"
3-(Hydroxymethyl)Octan-2-One	CCCCCC(CO)C(C)=O	"musty, earthy, sweet, herbal"
Hexanoic Acid	CCCCCC(O)=O	"fatty, sour, sweat, cheese"
1-Octen-3-Ol	CCCCCC(O)C=C	"raw, fishy, oily, earthy, fungal, chicken, mushroom, green"
3-Octanol	CCCCCC(O)CC	"citrus, nut, moss, herbal, earthy, woody, melon, minty, mushroom, spicy"
Gingerol	CCCCCC(O)CC(=O)CCC1CCC(O)C(C1)OC	pungent
Ethyl 3-Hydroxyoctanoate	CCCCCC(O)CC(=O)OCC	"floral, fruity, winey"
1-Octen-3-Yl Butyrate	CCCCCC(OC(=O)CCC)C=C	"butter, animal, fishy, fruity, mushroom"
1-Octen-3-Yl Acetate	CCCCCC(OC(C)=O)C=C	"herbal, fresh, oily, fruity, lavender, green"
"Deca-2,4-Dienal"	CCCCCC=CC=CC=O	seaweed
Dec-4-Enal	CCCCCC=CCCC=O	"fatty, citrus, orange, aldehydic"
Hexanal	CCCCCC=O	"leafy, grass, sweaty, tallow, fat, fresh, fatty, fruity, aldehydic, green"
Dihydrojasmone	CCCCCC1=C(C)CCC1=O	"spice, outdoor, jasmin, herbal, fresh, myrrh, woody"
6-Pentyl-2H-Pyran-2-One	CCCCCC1=CC=CC(=O)O1	"coconut, lactonic, almond, waxy, fatty, creamy, mushroom, tonka"
24851-98-7	CCCCCC1C(CCC1=O)CC(=O)OC	"lactonic, jasmin, floral, oily, tropical, natural, green"
Massoia Lactone	CCCCCC1CC=CC(=O)O1	"peach, coconut, herbal, sweet, creamy"
Delta-Decalactone	CCCCCC1CCCC(=O)O1	"peach, butter, coconut, apricot, fresh, oily, creamy, plum, sweet, fruity, dairy"
2-Pentylpyridine	CCCCCc1ccccn1	"tallow, pepper, fat, herbal, fatty, mushroom, green"
5-Pentylfuran-2(5H)-One	CCCCCC1OC(=O)C=C1	"minty, fruity"
"4-Methyl-2-Pentyl-1,3-Dioxolane"	CCCCCC1OCC(C)O1	"vegetable skin, rue, licorice, petroleum, waxy, fresh, clean, green"
2-Pentylfuran	CCCCCc1occc1	"butter, green bean, vegetable, earthy, beany, fruity, metallic, green"
2-Pentylthiophene	CCCCCc1sccc1	"fatty, fruit, sweet, fruity, cranberry"
Heptane	CCCCCCC	"alkane, ethereal, sweet"
Methyl 2-Nonynoate	CCCCCCC#CC(=O)OC	"floral, cucumber, melon, leaf, violet, green"
Ethyl 2-Nonynoate	CCCCCCC#CC(=O)OCC	"leaves, floral, violet, green"
3-Nonanone	CCCCCCC(=O)CC	"jasmin, herbal, fresh, sweet, fruity, leaf, spicy"
Methyl Heptanoate	CCCCCCC(=O)OC	"berry, waxy, floral, fruit, sweet, orris, green"
Ethyl Heptanoate	CCCCCCC(=O)OCC	"pineapple, wine, fruit, plum, fruity, melon, rum, cognac"
Isobutyl Heptanoate	CCCCCCC(=O)OCC(C)C	"herbal, fruity, green"
Allyl Heptanoate	CCCCCCC(=O)OCC=C	"berry, pineapple, apricot, banana, waxy, sweet, fusel, fruity, cognac"
Butyl Heptanoate	CCCCCCC(=O)OCCCC	"apple, herbal, cut grass, fruity, marigold"
Pentyl Heptanoate	CCCCCCC(=O)OCCCCC	"lemon, coconut, ethereal, unripe banana, fruity"
Octan-2-One	CCCCCCC(C)=O	"natural, earthy, gasoline, weedy, herbal, woody, bitter, soap"
2-Methyloctanal	CCCCCCC(C)C=O	None
Octan-2-Ol	CCCCCCC(C)O	"fat, herbal, fresh, earthy, woody, mushroom, spicy, green"
2-Acetoxyoctane	CCCCCCC(C)OC(C)=O	fruit
Nonan-3-Yl Acetate	CCCCCCC(CC)OC(C)=O	"ethereal, herbal, fruity"
Heptanoic Acid	CCCCCCC(O)=O	"sour, cheesy, sweat, rancid, cheese"
1-Nonen-3-Ol	CCCCCCC(O)C=C	"oily, earthy, creamy, intensely, mushroom, green"
"1,1-Dimethoxyheptane"	CCCCCCC(OC)OC	"orange, privet, tropical, fruity, green"
Gamma-Undecalactone	CCCCCCC[C@H]1CCC(=O)O1	"peach, coconut, lactonic, apricot, fatty, creamy, fruity, ketonic"
1-Octene	CCCCCCC=C	gasoline
2-Nonenoic Acid	CCCCCCC=CC(O)=O	fatty
Heptanal	CCCCCCC=O	"citrus, ozone, fat, herbal, fresh, wine-lee, rancid, fatty, aldehydic, green"
Gamma-Nonanolactone	CCCCCCC1CC(=O)O1	"peach, coconut, waxy, oily, creamy, sweet, buttery"
2-Hexyl-4-Acetoxytetrahydrofuran	CCCCCCC1CC(CO1)OC(C)=O	"floral, sweet, fruity"
Gamma-Decalactone	CCCCCCC1CCC(=O)O1	"peach, coconut, caramel, fat, waxy, fresh, oily, fatty, sweet, fruity, strong, buttery"
Delta-Undecalactone	CCCCCCC1CCCC(=O)O1	"peach, coconut, waxy, fatty, creamy, fruity"
7-Hexyloxepan-2-One	CCCCCCC1CCCCC(=O)O1	"peach, sweet, fruity, celery"
5-Hexyl-4-Methyldihydrofuran-2(3H)-One	CCCCCCC1OC(=O)CC1C	floral
"2-Hexyl-4,5-Dimethyl-1,3-Dioxolane"	CCCCCCC1OC(C)C(C)O1	"fruity, dairy"
"2-Hexyl-4-Methyl-1,3-Dioxolane"	CCCCCCC1OCC(C)O1	"fatty, green"
Heptanal Glyceryl Acetal	CCCCCCC1OCC(CO)O1	"earthy, fungal, sweet"
2-Hexylthiophene	CCCCCCc1sccc1	"floral, gassy, fruity, meaty, green"
Octane	CCCCCCCC	"alkane, gasoline"
3-Decanone	CCCCCCCC(=O)CC	"citrus, orange, waxy, floral, fruity, green"
Paradol	CCCCCCCC(=O)CCc1ccc(O)c(OC)c1	"herbal, spicy"
Methyl Octanoate	CCCCCCCC(=O)OC	"orange, vegetable, herbal, waxy, sweet, aldehydic, green"
Linalyl Octanoate	CCCCCCCC(=O)OC(C)(CCC=C(C)C)C=C	"herbal, dry, sweet, fruity, natural, green"
P-Cresyl Caprylate	CCCCCCCC(=O)Oc1ccc(C)cc1	"jasmin, animal, hay, fecal, indole, ylang, green"
Ethyl Octanoate	CCCCCCCC(=O)OCC	"apricot, fat, wine, waxy, banana, brandy, fruit, sweet, fruity, pear"
Tricaprylin	CCCCCCCC(=O)OCC(COC(=O)CCCCCCC)OC(=O)CCCCCCC	odorless
Allyl Octanoate	CCCCCCCC(=O)OCC=C	"butter, pineapple, waxy, banana, fatty, sweet, fruity, tropical, green"
Furfuryl Octanoate	CCCCCCCC(=O)OCc1occc1	"peach, waxy, sweet, fruity, metallic"
Isopentyl Octanoate	CCCCCCCC(=O)OCCC(C)C	"coconut, pineapple, oily, sweet, fruity, soapy, green"
Butyl Octanoate	CCCCCCCC(=O)OCCCC	"butter, ether, herbal, fruit, dank"
Amyl Octanoate	CCCCCCCC(=O)OCCCCC	"orris, sweet, wine"
Hexyl Octanoate	CCCCCCCC(=O)OCCCCCC	"oil, apple, berry, waxy, ester, fruity, herb, green"
2-Nonanone	CCCCCCCC(C)=O	"soap, herbal, fresh, fishy, hot milk, earthy, sweet, soapy, weedy, green"
2-Nonanol	CCCCCCCC(C)O	"citrus, orange, waxy, cucumber, creamy, fruity, cheese, green"
Octanoic Acid	CCCCCCCC(O)=O	"cheesy, sweat, vegetable, waxy, fatty, rancid, oily, cheese"
"1,1-Dimethoxyoctane"	CCCCCCCC(OC)OC	"leafy, citrus, rose, floral, violet, green"
"9-Octadecenal, (9E)-"	CCCCCCCC/C=C/CCCCCCCC=O	None
Octanal	CCCCCCCC=O	"lemon, citrus, soap, orange peel, fat, waxy, fatty, aldehydic, green"
3-Heptyldihydro-5-Methyl-2(3H)-Furanone	CCCCCCCC1CC(C)OC1=O	"creamy, lactonic, waxy, green"
Delta-2-Dodecenolactone	CCCCCCCC1CC=CC(=O)O1	"fatty, coconut, lactonic, creamy"
Delta-Dodecalactone	CCCCCCCC1CCCC(=O)O1	"peach, butter, coconut, fresh, oily, fruit, sweet, creamy, metallic, buttery, cheese"
2-Heptylfuran	CCCCCCCc1occc1	"lactonic, roasted, fatty, oily, nutty, green"
Nonane	CCCCCCCCC	"alkane, gasoline"
1-Decyne	CCCCCCCCC#C	None
Methyl 2-Undecynoate	CCCCCCCCC#CC(=O)OC	"waxy, floral, fruity, violet, green"
"Undecane-2,3-Dione"	CCCCCCCCC(=O)C(C)=O	"waxy, fatty, creamy, dairy, aldehydic"
Nonivamide	CCCCCCCCC(=O)NCc1ccc(O)c(OC)c1	"bland, odorless"
Methyl Nonanoate	CCCCCCCCC(=O)OC	"coconut, wine, waxy, sweet, fruity, tropical, pear"
Ethyl Nonanoate	CCCCCCCCC(=O)OCC	"rose, wine, waxy, rum, fruity, tropical, natural"
Allyl Nonanoate	CCCCCCCCC(=O)OCC=C	"pineapple, vinous, wine, waxy, sweet, creamy, fruity"
Hexyl Nonanoate	CCCCCCCCC(=O)OCCCCCC	"fruity, vegetable, brandy, green"
2-Decanone	CCCCCCCCC(C)=O	"floral, orange, peach, fatty"
2-Hexyl-1-Decanol	CCCCCCCCC(CO)CCCCCC	None
Nonanoic Acid	CCCCCCCCC(O)=O	"cultured dairy, fat, waxy, green, dirty, cheese"
"1,1-Dimethoxynonane"	CCCCCCCCC(OC)OC	"citrus, fresh, floral, plastic, green"
"2,3-Dihydroxypropyl Octadec-9-Enoate"	CCCCCCCCC=CCCCCCCCC(=O)OCC(O)CO	None
Nonanal	CCCCCCCCC=O	"citrus, lime, orange peel, rose, fat, green, fishy, waxy, fresh, fatty, peely, aldehydic, orris, grapefruit"
Gamma-Dodecalactone	CCCCCCCCC1CCC(=O)O1	"peach, fatty, musty, fruit, sweet, fruity, metallic, flower"
"4-Methyl-2-Octyl-1,3-Dioxolane"	CCCCCCCCC1OCC(C)O1	fruity
Decane	CCCCCCCCCC	alkane
Methyl Decanoate	CCCCCCCCCC(=O)OC	"oily, floral, wine, fruity"
Ethyl Decanoate	CCCCCCCCCC(=O)OCC	"apple, brandy, waxy, grape, oily, sweet, fruity, pear"
Isoamyl Decanoate	CCCCCCCCCC(=O)OCCC(C)C	"banana, waxy, sweet, fruity, cognac, green"
Phenethyl Decanoate	CCCCCCCCCC(=O)OCCc1ccccc1	None
Butyl Decanoate	CCCCCCCCCC(=O)OCCCC	whiskey
Hexyl Decanoate	CCCCCCCCCC(=O)OCCCCCC	"fresh, green"
2-Undecanone	CCCCCCCCCC(C)=O	"orange, waxy, fresh, fatty, floral, iris, creamy, fruity, orris, green"
2-Methylundecanal	CCCCCCCCCC(C)C=O	"citrus, tuberose, amber, moss, fresh, waxy, coumarinic, aldehydic, metallic"
2-Undecanol	CCCCCCCCCC(C)O	"waxy, cotton, fresh, sarsaparilla, clean cloth"
Decanoic Acid	CCCCCCCCCC(O)=O	"sour, citrus, fat, rancid, fatty, unpleasant"
"1,1-Dimethoxydecane"	CCCCCCCCCC(OC)OC	"neroli, citrus, herbal, green"
Decanal	CCCCCCCCCC=O	"citrus, soap, orange peel, tallow, waxy, floral, sweet, aldehydic"
"4-Methyl-2-Nonyl-1,3-Dioxolane"	CCCCCCCCCC1OCC(C)O1	"floral, green"
Undecane	CCCCCCCCCCC	alkane
Ethyl Undecanoate	CCCCCCCCCCC(=O)OCC	"coconut, waxy, fatty, soapy, cognac"
2-Dodecanone	CCCCCCCCCCC(C)=O	"floral, citrus, orange, fruity"
Undecanoic Acid	CCCCCCCCCCC(O)=O	"oil, coconut, waxy, fatty, creamy, cheese"
Tridec-2-Enal	CCCCCCCCCCC=CC=O	None
Undecanal	CCCCCCCCCCC=O	"oil, laundry, citrus, waxy, fresh, floral, fatty, sweet, pungent, aldehydic, soapy, green"
Dodecane	CCCCCCCCCCCC	alkane
1-Tridecyne	CCCCCCCCCCCC#C	None
Methyl Dodecanoate	CCCCCCCCCCCC(=O)OC	"coconut, fat, waxy, creamy, soapy, mushroom"
4-Methylphenyl Dodecanoate	CCCCCCCCCCCC(=O)Oc1ccc(C)cc1	"floral, nutty, sweet, vanilla"
Ethyl Dodecanoate	CCCCCCCCCCCC(=O)OCC	"waxy, floral, sweet, clean, leaf, soapy"
Isoamyl Laurate	CCCCCCCCCCCC(=O)OCCC(C)C	"peach, wine, brandy, waxy, oily, fatty, rum, beer"
Butyl Laurate	CCCCCCCCCCCC(=O)OCCCC	"oil, waxy, oily, fruity, peanut, soapy"
2-Tridecanone	CCCCCCCCCCCC(C)=O	"coconut, herbal, milky, waxy, fatty, earthy, dairy, nutty"
2-Methyltridecane	CCCCCCCCCCCC(C)C	None
Lauric Acid	CCCCCCCCCCCC(O)=O	"coconut, mild, fatty, metal, bay oil"
"1,1-Dimethoxydodecane"	CCCCCCCCCCCC(OC)OC	"mild, herbal, waxy, fresh, orchid, green"
Dodecanal	CCCCCCCCCCCC=O	"citrus, fat, waxy, floral, lily, aldehydic, soapy, green"
Tridecane	CCCCCCCCCCCCC	alkane
2-Methyltetradecane	CCCCCCCCCCCCC(C)C	None
3-Methylpentadecane	CCCCCCCCCCCCC(C)CC	None
Tridecanoic Acid	CCCCCCCCCCCCC(O)=O	"woody, waxy"
Tridecanal	CCCCCCCCCCCCC=O	"grapefruit peel, citrus, must, fresh, waxy, sweet, clean, aldehydic, soapy, flower, petal"
Dodecylbenzene	CCCCCCCCCCCCc1ccccc1	None
Tetradecane	CCCCCCCCCCCCCC	"alkane, waxy, mild"
Methyl Tetradecanoate	CCCCCCCCCCCCCC(=O)OC	"fatty, orris, waxy, petal"
Isopropyl Myristate	CCCCCCCCCCCCCC(=O)OC(C)C	"oily, fatty, faint, cinnamon"
Ethyl Tetradecanoate	CCCCCCCCCCCCCC(=O)OCC	"ether, waxy, sweet, soapy, orris, violet"
2-Pentadecanone	CCCCCCCCCCCCCC(C)=O	"jasmin, fresh, celery"
Tetradecanoic Acid	CCCCCCCCCCCCCC(O)=O	"fatty, soapy, waxy, coconut"
Tetradecanal	CCCCCCCCCCCCCC=O	"citrus peel, incense, amber, wax, waxy, fatty, musk, flower, dry"
Pentadecane	CCCCCCCCCCCCCCC	"alkane, waxy"
Hexadecan-2-One	CCCCCCCCCCCCCCC(C)=O	"fruit, fruity"
Pentadecanoic Acid	CCCCCCCCCCCCCCC(O)=O	waxy
1-Hexadecene	CCCCCCCCCCCCCCC=C	None
Pentadecanal	CCCCCCCCCCCCCCC=O	"waxy, fresh"
Hexadecane	CCCCCCCCCCCCCCCC	alkane
Methyl Palmitate	CCCCCCCCCCCCCCCC(=O)OC	"oily, fatty, waxy"
Isopropyl Palmitate	CCCCCCCCCCCCCCCC(=O)OC(C)C	"oily, bland, fat"
Ethyl Palmitate	CCCCCCCCCCCCCCCC(=O)OCC	"mild, wax, milky, waxy, creamy, fruity, balsam"
Palmitic Acid	CCCCCCCCCCCCCCCC(O)=O	"fatty, slightly waxy"
1-Hexadecanesulfonyl Chloride	CCCCCCCCCCCCCCCC[S](Cl)(=O)=O	None
Hexadecanal	CCCCCCCCCCCCCCCC=O	cardboard
Heptadecane	CCCCCCCCCCCCCCCCC	alkane
Octadecane	CCCCCCCCCCCCCCCCCC	alkane
Methyl Stearate	CCCCCCCCCCCCCCCCCC(=O)OC	"oily, fat, waxy"
Ethyl Stearate	CCCCCCCCCCCCCCCCCC(=O)OCC	"waxy, mild"
Sorbitan Monostearate	CCCCCCCCCCCCCCCCCC(=O)OCC(O)[C@H]1OC[C@@H](O)[C@@H]1O	None
Glyceryl Monostearate	CCCCCCCCCCCCCCCCCC(=O)OCC(O)CO	"fatty, waxy, mild"
Butyl Stearate	CCCCCCCCCCCCCCCCCC(=O)OCCCC	"fatty, oily, mild"
Stearic Acid	CCCCCCCCCCCCCCCCCC(O)=O	"fatty, odorless, mild"
Octadecanal	CCCCCCCCCCCCCCCCCC=O	"oil, oily"
Nonadecane	CCCCCCCCCCCCCCCCCCC	"alkane, bland"
Eicosane	CCCCCCCCCCCCCCCCCCCC	"alkane, waxy"
Heneicosane	CCCCCCCCCCCCCCCCCCCCC	"alkane, waxy"
Docosane	CCCCCCCCCCCCCCCCCCCCCC	"alkane, waxy"
Tricosane	CCCCCCCCCCCCCCCCCCCCCCC	"alkane, waxy"
Tetracosane	CCCCCCCCCCCCCCCCCCCCCCCC	None
Pentacosane	CCCCCCCCCCCCCCCCCCCCCCCCC	None
Tetracontane	CCCCCCCCCCCCCCCCCCCCCCCCCCCCCCCCCCCCCCCC	None
1-Triacontanol	CCCCCCCCCCCCCCCCCCCCCCCCCCCCCCO	None
1-Chlorooctadecane	CCCCCCCCCCCCCCCCCCCl	None
Octadecan-1-Ol	CCCCCCCCCCCCCCCCCCO	"oil, bland"
Omggp	CCCCCCCCCCCCCCCCCCOCC(CO[C@@H]1O[C@H](CO)[C@@H](O)[C@H](O)[C@H]1O)OC	sweet
1-Hexadecanol	CCCCCCCCCCCCCCCCO	"wax, floral, waxy, flower"
1-Pentadecanol	CCCCCCCCCCCCCCCO	None
1-Tetradecanol	CCCCCCCCCCCCCCO	"coconut, orris, fruity, waxy"
1-Tridecanol	CCCCCCCCCCCCCO	"must, musty"
1-Dodecanol	CCCCCCCCCCCCO	"coconut, wax, fat, waxy, fatty, earthy, honey, soapy"
Dodecyl Gallate	CCCCCCCCCCCCOC(=O)c1cc(O)c(O)c(O)c1	odorless
Lauryl Propionate	CCCCCCCCCCCCOC(=O)CC	fruity
Lauryl 3-Mercaptopropionate	CCCCCCCCCCCCOC(=O)CCS	None
Dilauryl Thiodipropionate	CCCCCCCCCCCCOC(=O)CCSCCC(=O)OCCCCCCCCCCCC	"ethereal, sweet"
Dodecyl Acetate	CCCCCCCCCCCCOC(C)=O	"waxy, fresh, sweet, clean, laundered cloths"
1-Undecanol	CCCCCCCCCCCO	"citrus, clean clothes, rose, waxy, fresh, mandarin, floral, soapy"
1-Decanol	CCCCCCCCCCO	"orange, rose, fat, waxy, fatty, floral, sweet, clean, watery"
Decyl Acetate	CCCCCCCCCCOC(C)=O	"oil, citrus, orange, pineapple, rose, waxy, fresh, clean, laundered cloths, soapy"
1-Nonanol	CCCCCCCCCO	"fatty, dusty, rose, fat, floral, green, clean, wet, orange, fresh, bitter, oily"
69984-73-2	CCCCCCCCCO[C@@H]1O[C@H](CO)[C@@H](O)[C@H](O)[C@H]1O	sweet
Nonyl Acetate	CCCCCCCCCOC(C)=O	"waxy, gardenia, soapy, tropical, fruit, green, clean, sweet, bitter, fruity"
Nonyl D-Glucoside	CCCCCCCCCOC1OC(CO)C(O)C(O)C1O	sweet
1-Octanol	CCCCCCCCO	"burnt, orange, rose, waxy, chemical, metal, aldehydic, mushroom, green"
29836-26-8	CCCCCCCCO[C@@H]1O[C@H](CO)[C@@H](O)[C@H](O)[C@H]1O	sweet
Octyl Isobutyrate	CCCCCCCCOC(=O)C(C)C	"waxy, oily, creamy, clean, fruity, soapy, green"
Octyl Benzoate	CCCCCCCCOC(=O)c1ccccc1	"fruity, balsam"
Octyl 2-Furoate	CCCCCCCCOC(=O)c1occc1	"tallow, waxy, oily, earthy, creamy, mushroom"
Octyl Propionate	CCCCCCCCOC(=O)CC	"jammy, floral, sweet, fruity, mushroom, raspberry, green"
Octyl Phenylacetate	CCCCCCCCOC(=O)Cc1ccccc1	"orange, rooty, basil, earthy, honey, bois de rose"
Octyl Butyrate	CCCCCCCCOC(=O)CCC	"jasmin, waxy, fresh, oily, earthy, creamy, fruity, natural, green"
Dioctyl Adipate	CCCCCCCCOC(=O)CCCCC(=O)OCCCCCCCC	"fatty, mild"
Octyl Octanoate	CCCCCCCCOC(=O)CCCCCCC	"oily, coconut, fruity"
Octyl Acetate	CCCCCCCCOC(C)=O	"herbal, waxy, earthy, mushroom, green"
Octyl Formate	CCCCCCCCOC=O	"orange, rose, waxy, fruity, cucumber"
Octyl D-Glucopyranoside	CCCCCCCCOC1O[C@H](CO)[C@@H](O)[C@H](O)[C@H]1O	sweet
Heptyl Isothiocyanate	CCCCCCCN=C=S	None
1-Heptanol	CCCCCCCO	"leafy, coconut, herbal, peony, strawberry, chemical, musty, sweet, woody, violet, green"
Heptyl 2-Methylpropanoate	CCCCCCCOC(=O)C(C)C	"apple, orange, warm, apricot, grape, floral, sweet, fruity, cherry, pear, raspberry, green"
Heptyl Butyrate	CCCCCCCOC(=O)CCC	"chamomile, floral, sweet, tropical, fruity, clean, tea, green"
Heptyl Heptanoate	CCCCCCCOC(=O)CCCCCC	"grassy, green"
Heptyl Octanoate	CCCCCCCOC(=O)CCCCCCC	"fresh, waxy, oily, tropical, green"
Heptyl Acetate	CCCCCCCOC(C)=O	"apricot, fresh, ripe, fruit, woody, rum, pear, green"
Heptyl Formate	CCCCCCCOC=O	"apple, herbal, waxy, floral, cucumber, plum, green"
Heptyl D-Glucoside	CCCCCCCOC1OC(CO)C(O)C(O)C1O	sweet
1-Heptanethiol	CCCCCCCS	"onion, sulfurous"
Hexylamine	CCCCCCN	"musty, ammoniacal, fishy"
Hexyl Isothiocyanate	CCCCCCN=C=S	"sharp, green"
1-Hexanol	CCCCCCO	"oil, alcoholic, ethereal, resin, fusel, sweet, fruity, flower, green"
1-Methoxyhexane	CCCCCCOC	"painty, herbal, sweet, fruity, lavender"
Hexyl Isobutyrate	CCCCCCOC(=O)C(C)C	"apple, berry, wine, grape, ripe, sweet, fruity, pear, green"
Hexyl 2-Methylbutanoate	CCCCCCOC(=O)C(C)CC	"apple, waxy, strawberry, fruity, tropical, spicy, green"
Hexyl Benzoate	CCCCCCOC(=O)c1ccccc1	"fresh, sappy, woody, clean, balsam"
Hexyl 2-Furoate	CCCCCCOC(=O)c1occc1	"apple, waxy, floral, sweet, pear, green"
Hexyl Propionate	CCCCCCOC(=O)CC	"musty, fruit, fruity, melon, pear, rotting, green"
Hexyl Isovalerate	CCCCCCOC(=O)CC(C)C	"apple skin, strawberry, sweet, fruity, unripe fruit, green"
Hexyl Butyrate	CCCCCCOC(=O)CCC	"apple, apple peel, waxy, sweet, fruity, soapy, green"
Hexyl Hexanoate	CCCCCCOC(=O)CCCCC	"peach, vegetable, herbal, apple peel, fresh, cut grass, fruity"
Hexyl Acetate	CCCCCCOC(C)=O	"apple, sweet, banana, fruit, green, herb, bitter, fruity"
5405-58-3	CCCCCCOC(C)OCCCCCC	"ethereal, herbal, waxy, sweet, green"
"1,1-Bis(Hexyloxy)Hexane"	CCCCCCOC(CCCCC)OCCCCCC	"grassy, green, mild"
Hexyl Formate	CCCCCCOC=O	"unripe plum, apple, sweet, banana"
1-Hexanethiol	CCCCCCS	"sulfur, burnt, sulfurous, roasted, garlic, fat, sulfury, fatty, meaty"
Amylamine	CCCCCN	"ammoniacal, fishy"
Pentyl Isothiocyanate	CCCCCN=C=S	green
1-Pentanol	CCCCCO	"oil, balsamic, vanilla, fusel, sweet, balsam"
Amyl 2-Methylbutyrate	CCCCCOC(=O)C(C)CC	"apple, fruity"
Pentyl Benzoate	CCCCCOC(=O)c1ccccc1	"amber, musky, floral, balsam, green"
Amyl Salicylate	CCCCCOC(=O)c1ccccc1O	"chocolate, herbal, floral, sweet, azalea, clover, green"
Amyl 2-Furoate	CCCCCOC(=O)c1occc1	"mild, herbal, fennel, oily, fruity"
Pentyl Propionate	CCCCCOC(=O)CC	"pineapple, sweet, fruity, apricot"
Pentyl Isovalerate	CCCCCOC(=O)CC(C)C	"apple, fruity, fresh"
Amyl Phenylacetate	CCCCCOC(=O)Cc1ccccc1	"chocolate, tobacco, balsam, animal"
Pentyl Butyrate	CCCCCOC(=O)CCC	"pineapple, banana, sweet, fruity, tropical, cherry"
Pentyl Valerate	CCCCCOC(=O)CCCC	"apple, fruity, ripe"
Pentyl Hexanoate	CCCCCOC(=O)CCCCC	"apple, pineapple, fatty, estery, sweet, fruity, pear, green"
Amyl Acetate	CCCCCOC(C)=O	"ethereal, fruity, banana"
Pentyl Formate	CCCCCOC=O	"ethereal, powerful, earthy, unripe banana, fruity, green"
Pentyl D-Sorbopyranoside	CCCCCOC1(CO)OC[C@@H](O)[C@H](O)[C@H]1O	sweet
Pentyl D-Glucoside	CCCCCOC1OC(CO)C(O)C(O)C1O	sweet
1-Pentanethiol	CCCCCS	"roast, sulfurous, vegetable, meat, fatty"
Butylamine	CCCCN	"ammonia, fishy"
Butyl Isothiocyanate	CCCCN=C=S	"sulfur, citrus, wine_like, vegetable, sulfury, fatty, floral, earthy, woody, pungent, fruity, herbaceous, nutty, meaty, spicy, green"
1-Butanol	CCCCO	"oil, vanilla, fruit, fusel, sweet, balsam, medicine, medicinal"
Butyl Beta-D-Glucopyranoside	CCCCO[C@@H]1O[C@H](CO)[C@@H](O)[C@H](O)[C@H]1O	sweet
Butyl Isobutyrate	CCCCOC(=O)C(C)C	"apple, banana, sweet, fruity, tropical, green"
Butyl 2-Methylbutyrate	CCCCOC(=O)C(C)CC	"chocolate, fruit, cocoa, fruity, green"
Butyl Lactate	CCCCOC(=O)C(C)O	"fermented, waxy, creamy, fruity, mushroom"
7492-70-8	CCCCOC(=O)C(C)OC(=O)CCC	"butter, coconut, buttermilk, creamy, dairy, buttery, cheese"
Butyl 4-Hydroxybenzoate	CCCCOC(=O)c1ccc(O)cc1	"very faint, phenolic"
Butyl Benzoate	CCCCOC(=O)c1ccccc1	"balsamic, amber, mild, fruity, balsam"
Dibutyl Phthalate	CCCCOC(=O)c1ccccc1C(=O)OCCCC	faint
Butyl Anthranilate	CCCCOC(=O)c1ccccc1N	"berry, powdery, wine, grape, floral, sweet, plum, fruity, petitgrain"
Butyl Salicylate	CCCCOC(=O)c1ccccc1O	"harsh, clover, ethyl benzoate"
Butyl Propionate	CCCCOC(=O)CC	"rose, banana, earthy, weak, sweet"
Butyl Acetoacetate	CCCCOC(=O)CC(C)=O	"brandy, fermented, sweet, fruity"
Butyl Isovalerate	CCCCOC(=O)CC(C)C	"peach, apple, pineapple, fruit, sweet, pear, green"
Acetyl Tributyl Citrate	CCCCOC(=O)CC(CC(=O)OCCCC)(OC(C)=O)C(=O)OCCCC	"very faint, sweet, herbal, wine"
Butyl Phenylacetate	CCCCOC(=O)Cc1ccccc1	"rose, chocolate, honey"
Butyl Butyrate	CCCCOC(=O)CCC	"peach, apple, berry, pineapple, banana, sweet, fruity, pear"
Butyl Levulinate	CCCCOC(=O)CCC(C)=O	"herbal, bitter, caramel, fruity, waxy"
Butyl Pentanoate	CCCCOC(=O)CCCC	"apple, pineapple, sweet, fruity, tropical, raspberry, green"
Dibutyl Sebacate	CCCCOC(=O)CCCCCCCCC(=O)OCCCC	"oily, fruity, faint"
Butyl Undec-10-Enoate	CCCCOC(=O)CCCCCCCCC=C	"butter, wine, fatty, floral, fruity"
Butyl Acetate	CCCCOC(C)=O	"solvent, ethereal, banana, fruity, pear"
64577-91-9	CCCCOC(C)OCCc1ccccc1	"leafy, vegetable, green"
Butyl Formate	CCCCOC=O	"brandy, plum, fruity, rum"
Benzyl Butyl Ether	CCCCOCc1ccccc1	"floral, rose"
2-Butoxyethyl Acetate	CCCCOCCOC(C)=O	None
1-Butanethiol	CCCCS	"garlic, onion, egg, sulfury, coffee"
Dibutyl Sulfide	CCCCSCCCC	"rose, herbal, violet-leaf, geranium, grassy, green"
Dibutyl Disulfide	CCCCSSCCCC	sulfurous
Propylamine	CCCN	ammoniacal
Tripropylamine	CCCN(CCC)CCC	"ammoniacal, fishy"
1-Propanol	CCCO	"alcoholic, fermented, alcohol, musty, fusel, pungent, peanut"
Pgrr	CCCO[C@@H]1O[C@@H](C)[C@H](O)[C@@H](OC)[C@H]1O[C@@H]2O[C@@H](C)[C@H](O[C@@H]3O[C@H](COC)[C@@H](O)[C@H](OC)[C@H]3O)C(OC)[C@H]2OC	sweet
93496-18-5	CCCO[C@H]1O[C@H](CO)[C@H](O[C@@H]2O[C@H](CO)[C@H](O)[C@H](O)[C@H]2O)[C@H](O)[C@H]1O	sweet
Propyl Isobutyrate	CCCOC(=O)C(C)C	"berry, ripe, sweet, melon, tropical, fruity"
Propyl Gallate	CCCOC(=O)c1cc(O)c(O)c(O)c1	"bland, bitter"
Propyl 4-Hydroxybenzoate	CCCOC(=O)c1ccc(O)cc1	"burnt, smoky, sweet, woody, hawthorn"
Propyl Benzoate	CCCOC(=O)c1ccccc1	"nutty, balsam"
Propyl 2-Furoate	CCCOC(=O)c1occc1	"earthy, sweet, herbal"
Propyl Propionate	CCCOC(=O)CC	"sweet, pungent, chemical, pineapple, sharp, bitter, fruity"
Propyl Isovalerate	CCCOC(=O)CC(C)C	"sweet, bitter, apple, fruity"
Propyl Butyrate	CCCOC(=O)CCC	"solvent, pineapple, apricot, sweaty, rancid, sweet, fruity"
Dipropyl Adipate	CCCOC(=O)CCCCC(=O)OCCC	"alcoholic, mild"
Propyl Acetate	CCCOC(C)=O	"solvent, fusel, pear, celery, raspberry, bitter, fruity"
(2-(1-Propoxyethoxy)Ethyl)Benzene	CCCOC(C)OCCc1ccccc1	"leafy, reseda, herbal, hyacinth, green"
Propyl Formate	CCCOC=O	"rum, sweet, green, berry, ethereal, bitter, fruity"
5-Nitro-2-Propoxyaniline	CCCOc1ccc(cc1N)[N+]([O-])=O	sweet
Propyl D-Glucoside	CCCOC1OC(CO)C(O)C(O)C1O	sweet
1-Propoxy-2-Propanol	CCCOCC(C)O	None
N-Propyl Nitrite	CCCON=O	None
1-Propanethiol	CCCS	"cabbage, onion, sweet, gassy, natural"
Methyl Propyl Sulfide	CCCSC	"leek, creamy, alliaceous, green"
S-Propyl Thioacetate	CCCSC(C)=O	"garlic, onion, sulfurous, green"
Allyl Propyl Sulfide	CCCSCC=C	"garlic, onion, green"
Propyl Sulfide	CCCSCCC	"garlic, onion"
Methyl Propyl Disulfide	CCCSSC	"mustard, onion, tomato, radish, sulfury"
61197-09-9	CCCSSc1ccoc1C	meaty
Ethyl Propyl Disulfide	CCCSSCC	"garlic, onion, sulfurous, green"
Allyl Propyl Disulfide	CCCSSCC=C	"garlic, onion, alliaceous, green"
Dipropyl Disulfide	CCCSSCCC	"burnt, onion, sulfury, earthy, green"
Dipropyl Trisulfide	CCCSSSCCC	"sulfurous, garlic, onion, tropical, green"
Ethanamine	CCN	"ammonia, fishy"
Camphotamide	CCN(CC)C(=O)c1ccc[n+](C)c1.CC2(C)C3CCC2(C)C(=O)C3[S]([O-])(=O)=O	bitter
Nikethamide	CCN(CC)C(=O)c1cccnc1	bitter
Azintamide	CCN(CC)C(=O)CSc1ccc(Cl)nn1	bitter
Trapidil	CCN(CC)c1cc(C)nc2ncnn12	bitter
Triethylamine	CCN(CC)CC	"ammoniacal, fishy"
Syntropan	CCN(CC)CC(C)(C)COC(=O)C(CO)c1ccccc1.O[P](O)(O)=O	bitter
Chloroquine	CCN(CC)CCCC(C)Nc1ccnc2cc(Cl)ccc12	bitter
Chloroquine Diphosphate	CCN(CC)CCCC(C)Nc1ccnc2cc(Cl)ccc12.O[P](O)(O)=O.O[P](O)(O)=O	bitter
Procainamide	CCN(CC)CCNC(=O)c1ccc(N)cc1	bitter
Oxeladin	CCN(CC)CCOCCOC(=O)C(CC)(CC)c1ccccc1	bitter
Alverine Citrate	CCN(CCCc1ccccc1)CCCc2ccccc2.OC(=O)CC(O)(CC(O)=O)C(O)=O	bitter
Hydroxychloroquine Sulfate	CCN(CCO)CCCC(C)Nc1ccnc2cc(Cl)ccc12.O[S](O)(=O)=O	bitter
Ethyl Isothiocyanate	CCN=C=S	"garlic, mustard, pungent"
Lappaconitine	CCN1C[C@@]2(CC[C@H](OC)[C@@]34[C@@H]2C[C@@H](C13)[C@@]5(O)C[C@H](OC)[C@H]6C[C@@H]4[C@]5(O)[C@H]6OC)OC(=O)c7ccccc7NC(C)=O	bitter
Lomefloxacin	CCN1C=C(C(O)=O)C(=O)c2cc(F)c(N3CCNC(C)C3)c(F)c12	bitter
Enoxacin	CCN1C=C(C(O)=O)C(=O)c2cc(F)c(nc12)N3CCNCC3	bitter
Pipemidic Acid	CCN1C=C(C(O)=O)C(=O)c2cnc(nc12)N3CCNCC3	bitter
Roylin	CCN1CC2(CO)CCC(OC)C34C5CC6C(CC(O)(C5C6OC)C(O)(C(OC)C23)C14)OC	bitter
Aconine	CCN1CC2(COC)C(O)CC(OC)C34[C@@H]5C[C@@]6(O)C(O)[C@@H]5[C@](O)(C(O)C6OC)C(C(OC)[C@H]23)[C@@H]14	bitter
2-Acetyl-1-Ethylpyrrole	CCn1cccc1C(C)=O	nutty
39711-79-0	CCNC(=O)C1CC(C)CCC1C(C)C	None
Ethyl 2-(Ethylamino)Benzoate	CCNc1ccccc1C(=O)OCC	"neroli, tangerine, fruity, petitgrain"
Diethylamine	CCNCC	"ammoniacal, fishy"
Ethanol	CCO	"alcoholic, ethereal, medical, sweet, strong"
Ethyl D-Glucoside	CCO[C@@H]1O[C@H](CO)[C@@H](O)[C@H](O)[C@H]1O	sweet
"Ethyl 2,4-Dioxohexanoate"	CCOC(=O)C(=O)CC(=O)CC	None
Ethyl 2-Hydroxy-2-Methylbutanoate	CCOC(=O)C(C)(O)CC	"nutty, caramel"
"Ethyl 2-Methyl-3,4-Pentadienoate"	CCOC(=O)C(C)[CH]=[C]=[CH2]	"tutti frutti, strawberry, sweet, rum, tropical, fruity, green"
Ethyl Pyruvate	CCOC(=O)C(C)=O	None
Ethyl Isobutyrate	CCOC(=O)C(C)C	"rubber, alcoholic, ethereal, strawberry, sweet, fusel, fruity, rummy"
Ethyl 2-Methylbutyrate	CCOC(=O)C(C)CC	"apple, sharp, sweet, plum, fruity, green"
Ethyl 2-Methyl-4-Pentenoate	CCOC(=O)C(C)CC=C	"cooling, pineapple, banana, sweet, pungent, fruity, green"
Ethyl Lactate	CCOC(=O)C(C)O	"butterscotch, butter, tart, sharp, fruit, fruity, buttery"
Ethyl 2-(Methyldithio)Propionate	CCOC(=O)C(C)SSC	"fruity, sulfury"
Ethyl 2-Ethylbutanoate	CCOC(=O)C(CC)CC	None
Ethyl 2-Benzylbutanoate	CCOC(=O)C(CC)Cc1ccccc1	"floral, green"
Diethyl Tartrate	CCOC(=O)C(O)C(O)C(=O)OCC	"mild, must, wine, fruity, earth"
Ethyl Acrylate	CCOC(=O)C=C	"harsh, acrylate, fruity, plastic"
Ethyl Vanillate	CCOC(=O)c1ccc(O)c(OC)c1	"burnt, powdery, vanilla, smoky, guaiacol, fruit, sweet, metallic, flower, phenolic"
Ethylparaben	CCOC(=O)c1ccc(O)cc1	"phenolic, mild"
Ethyl 4-Methoxybenzoate	CCOC(=O)c1ccc(OC)cc1	"aniseed, anise, fruity, balsam, tarragon"
Ethyl Benzoate	CCOC(=O)c1ccccc1	"dry, celery, wintergreen, grape, cherry, fruity, sweet, plum, anise, musty, camomile, balsam, strawberry, fruit, minty, berry, cranberry, raspberry, bitter, banana, flower"
Ethyl Cyclohexanecarboxylate	CCOC(=O)C1CCCCC1	"winey, fruit, fruity, cheese"
Diethyl Phthalate	CCOC(=O)c1ccccc1C(=O)OCC	bitter
Ethyl 2-Aminobenzoate	CCOC(=O)c1ccccc1N	"grape, floral, wintergreen, sweet, blossom, orange blossom"
Ethyl 2-(Methylamino)Benzoate	CCOC(=O)c1ccccc1NC	"mandarin, sweet, soft, petitgrain"
Ethyl Salicylate	CCOC(=O)c1ccccc1O	"mint, floral, wintergreen, sweet, balsam, minty, spicy"
2-Phenyl-3-Carbethoxyfuran	CCOC(=O)c1ccoc1c2ccccc2	"cherry, fruity"
77-83-8	CCOC(=O)C1OC1(C)c2ccccc2	"strawberry, floral, fatty, sweet, fruity, honey"
Ethyl 3-Phenylglycidate	CCOC(=O)C1OC1c2ccccc2	"caramel, berry, strawberry, floral, sweet, tropical"
Ethyl 2-Furoate	CCOC(=O)c1occc1	plum
Ethyl Propionate	CCOC(=O)CC	"pineapple, grape, fruit, sweet, rum, fruity, juicy"
Ethyl Benzoylacetate	CCOC(=O)CC(=O)c1ccccc1	"sweet, cherry, bitter, acetophenone, fruity"
Diethyl Malonate	CCOC(=O)CC(=O)OCC	"apple, sweet, fruity, green"
Ethyl Acetoacetate	CCOC(=O)CC(C)=O	"apple, fresh, fatty, fruity, green"
Ethyl Isovalerate	CCOC(=O)CC(C)C	"apple, pineapple, tutti frutti, fruit, sweet, fruity"
Ethyl 3-Hydroxybutyrate	CCOC(=O)CC(C)O	"marshmallow, apple skin, grape, tropical, fruity, green"
Triethyl Citrate	CCOC(=O)CC(O)(CC(=O)OCC)C(=O)OCC	"odorless, mild, bitter, fruity, wine"
Diethyl Malate	CCOC(=O)CC(O)C(=O)OCC	None
Malathion	CCOC(=O)CC(S[P](=S)(OC)OC)C(=O)OCC	bitter
6290-17-1	CCOC(=O)CC1(C)OCC(C)O1	"apple, licorice, strawberry, fresh, fruity"
Ethyl Phenylacetate	CCOC(=O)Cc1ccccc1	"grapefruit, balsam, rose, anise, chocolate, honey, melon, fruit, sweet, floral, raspberry, bitter, cocoa"
Diethyl Succinate	CCOC(=O)CCC(=O)OCC	"peach, chocolate, apple, apricot, mild, wine, grape, musty, fruit, fruity, cranberry, pear, ylang, cooked"
Ethyl Levulinate	CCOC(=O)CCC(C)=O	"berry, pineapple, floral, sweet, fruity, rhubarb, green"
Ethyl 4-Methylpentanoate	CCOC(=O)CCC(C)C	"fruit, fruity"
Ethyl 4-Pentenoate	CCOC(=O)CCC=C	"caramel, warm, herbal, fruity, green"
Ethyl 3-Phenylpropionate	CCOC(=O)CCc1ccccc1	"rose, rum, fruity, honey, hyacinth, flower"
Ethyl 3-Cyclohexylpropanoate	CCOC(=O)CCC1CCCCC1	"peach, pineapple, powerful, sweet, fruity, pear"
Ethyl 3-(2-Furyl)Propionate	CCOC(=O)CCc1occc1	"pineapple, sweet, fruity, balsam"
Ethyl 4-Phenylbutanoate	CCOC(=O)CCCc1ccccc1	"sweet, plum, fruity"
Diethyl Sebacate	CCOC(=O)CCCCCCCCC(=O)OCC	"mild, wine, fruity, melon, quince"
Ethyl 10-Undecenoate	CCOC(=O)CCCCCCCCC=C	"waxy, musty, creamy, clean, fruity, soapy, cognac"
Ethyl 3-Mercaptopropionate	CCOC(=O)CCS	"meaty, skunk"
Ethyl 3-(Methylthio)Propionate	CCOC(=O)CCSC	"pineapple, tomato, sulfury, ripe, fruity, pulpy, metallic"
Ethyl (Methylthio)Acetate	CCOC(=O)CSC	"citrus, apricot, wine_like, vegetable, fatty, floral, earthy, woody, fruity, herbaceous, nutty, meaty, spicy, green"
Carbimazole	CCOC(=O)N1C=CN(C)C1=S	bitter
Ethyl Acetate	CCOC(C)=O	"pineapple, ethereal, sweet, anise, fruity, balsam, weedy, green"
Ethyl Isopropyl Ether	CCOC(C)C	None
Sec-Butyl Ethyl Ether	CCOC(C)CC	"floral, woody, berry"
1-Ethoxyethyl Acetate	CCOC(C)OC(C)=O	"fruity, fresh"
Acetal	CCOC(C)OCC	"cream, nut, tart, ether, vegetable, earthy, fruit, sweet, honey, green"
"1,1-Diethoxy-3-Methylbutane"	CCOC(CC(C)C)OCC	"fatty, fruity"
"(2,2-Diethoxyethyl)Benzene"	CCOC(Cc1ccccc1)OCC	"fresh, sweet, bluebell, almond, lime blossom, green"
Ethyl Formate	CCOC=O	"alcohol, rose, pungent, cognac, green, ethereal, bitter"
3-Ethoxy-4-Hydroxybenzaldehyde	CCOc1cc(C=O)ccc1O	"vanilla, caramel, sweet, creamy"
"2-Ethoxy-4-(4-Methyl-1,3-Dioxolan-2-Yl)Phenol"	CCOc1cc(ccc1O)C2OCC(C)O2	"vanilla, sweet, creamy, spicy"
4-Ethoxybenzaldehyde	CCOc1ccc(C=O)cc1	"floral, anisic, sweet, spicy"
4-Ethoxy-3-Methoxybenzaldehyde	CCOc1ccc(C=O)cc1OC	"floral, sweet, vanilla"
"2,4-Dinitrophenetole"	CCOc1ccc(cc1[N+]([O-])=O)[N+]([O-])=O	sweet-like
2-Ethoxy-5-Nitroaniline	CCOc1ccc(cc1N)[N+]([O-])=O	sweet-like
P-Lactophenetide	CCOc1ccc(NC(=O)C(C)O)cc1	bitter
"3-(4-Ethoxyphenyl)-1,1-Dimethylurea"	CCOc1ccc(NC(=O)N(C)C)cc1	sweet-like
Phenacetin	CCOc1ccc(NC(C)=O)cc1	bitter
Dulcin	CCOc1ccc(NC(N)=O)cc1	sweet
4-Ethoxyphenol	CCOc1ccc(O)cc1	"mild, phenolic, hawthorn, nutty, plastic"
7-Ethoxy-4-Methylcoumarin	CCOc1ccc2C(=CC(=O)Oc2c1)C	"nutty, walnut"
2-Ethoxynaphthalene	CCOc1ccc2ccccc2c1	"orange, powdery, naphtha, grape, floral, blossom"
"Hydrocupreine, O(Sup 6')-Ethyl-"	CCOc1ccc2nccc(C(O)C3CC4CCN3CC4CC)c2c1	bitter
2-Ethoxy-5-Methylpyrazine	CCOc1cnc(C)cn1	"nutty, roasted"
2-Ethoxy-6-Methylpyrazine	CCOc1cncc(C)n1	"nutty, roasted"
2-Ethoxy-3-Methylpyrazine	CCOc1nccnc1C	"hazelnut, earthy, roasted almonds, pineapple"
2-Ethoxythiazole	CCOc1sccn1	"burnt, roasted, nut, vegetable, meat, musty, phenolic"
4-(Ethoxymethyl)-2-Methoxyphenol	CCOCc1ccc(O)c(OC)c1	"alcoholic, chocolate, vanilla, smoky, sweet, rum, creamy, nutmeg, spicy"
(Ethoxymethyl)Benzene	CCOCc1ccccc1	"pineapple, powerful, fruity"
2-(Ethoxymethyl)Furan	CCOCc1occc1	"sweet, spicy"
3-Ethoxy-1-Propanol	CCOCCCO	fruit
Ethyl Nitrite	CCON=O	ether
Ethanethiol	CCS	"sulfurous, fruity"
Ethyl Methyl Sulfide	CCSC	"sulfur, garlic, vegetable, sulfury, fatty, earthy, woody, nutty, wine_like, meaty, spicy, citrus, sulfurous, coffee, herbaceous, green, cabbage, pyridine, tomato, fishy, floral, fruity"
S-Ethyl Ethanethioate	CCSC(C)=O	"garlic, onion, sulfury, coffee, fruity, meaty"
Diethyl Sulfide	CCSCC	"ethereal, sulfurous"
Ethyl Methyl Disulfide	CCSSC	"truffle, sulfurous"
Diethyl Disulfide	CCSSCC	"garlic, onion, ripe, gassy, greasy"
Ethyl Trisulfide	CCSSSCC	"garlic, onion, sulfurous"
Hydrochloric Acid	Cl	None
1-(2-Methoxyphenyl)-N-Methylpropan-1-Amine Hydrochloride	Cl.CCC(NC)c1ccccc1OC	bitter
2-Methoxy-5-Nitroaniline Hydrochloride	Cl.COc1ccc(cc1N)[N+]([O-])=O	sweet-like
L-Cysteine Hydrochloride	Cl.N[C@@H](CS)C(O)=O	odorless
2-Aminopentanedioic Acid Hydrochloride	Cl.NC(CCC(O)=O)C(O)=O	odorless
DL-Arginine Hydrochloride	Cl.NC(CCCNC(N)=N)C(O)=O	odorless
Miconazole	Clc1ccc(COC(Cn2ccnc2)c3ccc(Cl)cc3Cl)c(Cl)c1	bitter
"1,3-Dichlorobenzene"	Clc1cccc(Cl)c1	None
Chlorobenzene	Clc1ccccc1	None
Trimethylamine	CN(C)C	"sweaty, fish, fishy, oily, rancid, fruity"
Dioxypyramidon	CN(C)C(=O)C(=O)N(N(C)C(C)=O)c1ccccc1	bitter
"N,N-Dimethylthioformamide"	CN(C)C=S	bitter
Chlorpheniramine	CN(C)CCC(c1ccc(Cl)cc1)c2ccccn2.OC(=O)\C=C/C(O)=O	bitter
Diphenhydramine	CN(C)CCOC(c1ccccc1)c2ccccc2	bitter
Orphenadrine	CN(C)CCOC(c1ccccc1)c2ccccc2C	bitter
Pseudoephedrine	CN[C@@H](C)[C@@H](O)c1ccccc1	bitter
Pseudoephedrine Sulfate	CN[C@@H](C)[C@@H](O)c1ccccc1.O[S](O)(=O)=O	bitter
Vancomycin	CN[C@H](CC(C)C)C(=O)NC1[C@H](O)c2ccc(Oc3cc4cc(Oc5ccc(cc5Cl)[C@@H](O)[C@@H]6NC(=O)[C@H](NC(=O)[C@@H]4NC(=O)[C@H](CC(N)=O)NC1=O)c7ccc(O)c(c7)c8c(O)cc(O)cc8[C@@H](NC6=O)C(O)=O)c3O[C@@H]9O[C@H](CO)[C@@H](O)[C@H](O)[C@H]9O[C@H]%10C[C@](C)(N)[C@H](O)[C@H](C)O%10)c(Cl)c2	bitter
Streptomycin	CN[C@H]1[C@H](O)[C@@H](O)[C@H](CO)O[C@H]1O[C@H]2[C@@H](O[C@@H](C)[C@]2(O)C=O)O[C@H]3[C@H](O)[C@@H](O)[C@H](N=C(N)N)[C@@H](O)[C@@H]3N=C(N)N	bitter
Methyl Isothiocyanate	CN=C=S	"horseradish, mustard, pungent"
1-Methyl-2-Quinolinone	CN1C(=O)C=Cc2ccccc12	bitter
N-Methylsaccharin	CN1C(=O)c2ccccc2[S]1(=O)=O	sweet
Theophylline	CN1C(=O)N(C)c2nc[nH]c2C1=O	bitter
Aminophylline	CN1C(=O)N(C)c2nc[nH]c2C1=O.CN3C(=O)N(C)c4nc[nH]c4C3=O.NCCN	bitter
Dyphylline	CN1C(=O)N(C)c2ncn(CC(O)CO)c2C1=O	bitter
Trimethadione	CN1C(=O)OC(C)(C)C1=O	bitter
Deferiprone	CN1C=CC(=O)C(=C1C)O	bitter
1-Methyl-1H-Pyrrole	Cn1cccc1	"smoky, powerful, herbal, woody"
2-Acetyl-1-Methylpyrrole	Cn1cccc1C(C)=O	earthy
1192-58-1	Cn1cccc1C=O	None
Nicotine	CN1CCCC1c2cccnc2	bitter
Pirenzepine	CN1CCN(CC1)CC(=O)N2c3ccccc3C(=O)Nc4cccnc24	bitter
Azathioprine	Cn1cnc(c1Sc2ncnc3nc[nH]c23)[N+]([O-])=O	bitter
Caffeine	Cn1cnc2N(C)C(=O)N(C)C(=O)c12	"odorless, bitter"
Pentoxifylline	Cn1cnc2N(C)C(=O)N(CCCCC(C)=O)C(=O)c12	bitter
Theobromine	Cn1cnc2N(C)C(=O)NC(=O)c12	bitter
Antipyrine	CN1N(C(=O)C=C1C)c2ccccc2	bitter
Dimethylamine	CNC	None
51115-67-4	CNC(=O)C(C)(C(C)C)C(C)C	None
Isocom	CNC(C)CCC=C(C)C.OC(C(O)C(O)C(O)=O)C(O)C(O)=O	bitter
Phenylephrine	CNC[C@H](O)c1cccc(O)c1	bitter
Methyl 2-(Methylamino)Benzoate	CNc1ccccc1C(=O)OC	"orange, powdery, neroli, wine, grape, musty, sweet, fruity, blossom, phenolic"
Methanol	CO	alcoholic
"D-Fructose, 3-O-Methyl-"	CO[C@@H]([C@H](O)[C@H](O)CO)C(=O)CO	sweet
3'-O-Methyladenosine	CO[C@@H]1[C@@H](CO)O[C@H]([C@@H]1O)n2cnc3c(N)ncnc23	sweet-like
3-O-Methyl-Alpha-D-Glucopyranose	CO[C@@H]1[C@@H](O)[C@@H](O)O[C@H](CO)[C@H]1O	sweet
3-O-Methyl-D-Glucopyranose	CO[C@@H]1[C@@H](O)C(O)O[C@H](CO)[C@H]1O	sweet
Methyl Alpha-L-Rhamnopyranoside	CO[C@@H]1O[C@@H](C)[C@H](O)[C@@H](O)[C@H]1O	sweet
Methyl Glucoside Propoxylate	CO[C@@H]1O[C@H](CO)[C@@H](O)[C@H](O)[C@H]1O.CC(O)COC(C)CO.CC(O)COC(C)CO.CC(O)COC(C)CO.CC(O)COC(C)CO	sweet
Methyl Laminarabioside	CO[C@@H]1O[C@H](CO)[C@@H](O)[C@H](O[C@@H]2O[C@H](CO)[C@@H](O)[C@H](O)[C@H]2O)[C@H]1O	sweet
Methyl Beta-Cellobioside	CO[C@@H]1O[C@H](CO)[C@@H](O[C@@H]2O[C@H](CO)[C@@H](O)[C@H](O)[C@H]2O)[C@H](O)[C@H]1O	sweet
Methyl Lactoside	CO[C@@H]1O[C@H](CO)[C@@H](O[C@@H]2O[C@H](CO)[C@H](O)[C@H](O)[C@H]2O)[C@H](O)[C@H]1O	sweet
Deuterated Methyl Beta-Mannobioside	CO[C@@H]1O[C@H](CO)[C@@H](O[C@H]2O[C@H](CO)[C@@H](O)[C@H](O)[C@@H]2O)[C@H](O)[C@@H]1O	sweet
Methyl Beta-D-Galactopyranoside	CO[C@@H]1O[C@H](CO)[C@H](O)[C@H](O)[C@H]1O	sweet
Methyl 2-O-Alpha-Rhamnopyranosyl-Beta-Galactopyranoside	CO[C@@H]1O[C@H](CO)[C@H](O)[C@H](O)[C@H]1O[C@@H]2O[C@@H](C)[C@H](O)[C@@H](O)[C@H]2O	sweet
MeGRG	CO[C@@H]1O[C@H](CO)[C@H](O[C@@H]2O[C@H](CO)[C@@H](O)[C@H](O)[C@H]2O)[C@H](O)[C@H]1O[C@H]3O[C@H](C)[C@@H](O)[C@H](O)[C@@H]3O	sweet
Methyl O-(3-Deoxy-3-Fluorogalactopyranosyl)(1-6)Galactopyranoside	CO[C@@H]1O[C@H](CO[C@@H]2O[C@H](CO)[C@H](O)[C@H](F)[C@H]2O)[C@H](O)[C@H](O)[C@H]1O	sweet
Beta-Methylmelibiose	CO[C@@H]1O[C@H](CO[C@H]2O[C@H](CO)[C@H](O)[C@H](O)[C@H]2O)[C@@H](O)[C@H](O)[C@H]1O	sweet
69973-32-6	CO[C@@H]1OC[C@@H](O[C@@H]2OC[C@@H](O)[C@H](O)[C@H]2O)[C@H](O)[C@H]1O	sweet
3-O-Methyl-D-Glucose	CO[C@H]([C@@H](O)C=O)[C@H](O)[C@H](O)CO	sweet
3-O-Methylmannose	CO[C@H]([C@H](O)C=O)[C@H](O)[C@H](O)CO	sweet
Methyl Alpha-D-Glucopyranoside	CO[C@H]1O[C@H](CO)[C@@H](O)[C@H](O)[C@H]1O	sweet
"Methyl 2,3-Di-O-Methyl-Alpha-D-Glucopyranoside"	CO[C@H]1O[C@H](CO)[C@@H](O)[C@H](OC)[C@H]1OC	sweet
Methyl Alpha-D-Galactopyranoside	CO[C@H]1O[C@H](CO)[C@H](O)[C@H](O)[C@H]1O	sweet
Methyl Glucoside	CO[C@H]1OC(CO)[C@H](O)[C@@H](O)[C@@H]1O	sweet
107133-74-4	CO[P](O)(=S)OC[C@H]1O[C@@H]([C@H](O)[C@@H]1O)n2cnc3c(N)ncnc23	sweet-like
Phe-Phe-Ome	COC(=O)[C@H](Cc1ccccc1)NC(=O)[C@@H](N)Cc2ccccc2	sweet
22839-61-8	COC(=O)[C@H](Cc1ccccc1)NC(=O)C[C@H](N)C(O)=O	sweet
Yohimbine	COC(=O)[C@H]1[C@@H](O)CC[C@H]2CN3CCc4c([nH]c5ccccc45)[C@@H]3C[C@H]12	bitter
Methyl Methacrylate	COC(=O)C(C)=C	"acrylic, fruity, aromatic"
Methyl Isobutyrate	COC(=O)C(C)C	"apple, pineapple, floral, fruity, flower"
EINECS 251-590-3	COC(=O)C(Cc1ccccc1)NC(=O)C(CC(O)=O)NC=O	sweet
Aspartame	COC(=O)C(Cc1ccccc1)NC(=O)C(N)CC(O)=O	sweet
Methyl 2-(Acetylamino)-3-Phenylpropanoate	COC(=O)C(Cc1ccccc1)NC(C)=O	sweet
Methyl 2-Hydroxy-4-Methylpentanoate	COC(=O)C(O)CC(C)C	"musty, sweet, fruity"
Arecoline	COC(=O)C1=CCCN(C)C1	bitter
Verbenalin	COC(=O)C1=CO[C@@H](O[C@@H]2O[C@H](CO)[C@@H](O)[C@H](O)[C@H]2O)[C@@H]3[C@@H](C)CC(=O)[C@H]13	bitter
Atranorin	COC(=O)c1c(C)cc(OC(=O)c2c(C)cc(O)c(C=O)c2O)c(C)c1O	bitter
Methyl Vanillate	COC(=O)c1ccc(O)c(OC)c1	"butterscotch, caramel, warm, vanilla, spicy"
Methyl 4-Hydroxybenzoate	COC(=O)c1ccc(O)cc1	odorless
Methyl 4-Methoxybenzoate	COC(=O)c1ccc(OC)cc1	"herbal, sweet, anise, melon, balsam"
Methyl Benzoate	COC(=O)c1ccccc1	"prune, cananga, floral, wintergreen, lettuce, sweet, almond, herb, phenolic"
Methyl Cyclohexanecarboxylate	COC(=O)C1CCCCC1	"berry, pineapple, fruit, ester, estery, fruity, milk"
Methyl Anthranilate	COC(=O)c1ccccc1N	"neroli, flower, lemon, honey, strawberry, orange flower, grapefruit, medicinal, grape, bitter, fruity, lime"
Methyl 2-(Dimethylamino)Benzoate	COC(=O)c1ccccc1N(C)C	"orange, fruity, leaf"
Methyl 2-Acetamidobenzoate	COC(=O)c1ccccc1NC(C)=O	"powdery, fruity, strawberry, very mild"
Methyl Salicylate	COC(=O)c1ccccc1O	"mint, wintergreen, peppermint"
Methyl 2-Methoxybenzoate	COC(=O)c1ccccc1OC	"blackcurrant, cananga, herbal, floral, fruity, hyacinth"
Methyl Nicotinate	COC(=O)c1cccnc1	"tobacco, herbal, warm"
Methyl 2-Furoate	COC(=O)c1occc1	"tobacco, fungal, sweet, fruity, mushroom"
Dimethyl Malonate	COC(=O)CC(=O)OC	fruity
Methyl Acetoacetate	COC(=O)CC(C)=O	"citrus, fruity, fresh, green"
Methyl Isovalerate	COC(=O)CC(C)C	"strong, pineapple, apple, fruity"
Methyl Citronellate	COC(=O)CC(C)CCC=C(C)C	"apple, brandy, waxy, floral, sweet, fruity, geranium"
Methyl 3-Hydroxybutyrate	COC(=O)CC(C)O	"apple, mild"
Methyl Phenylacetate	COC(=O)Cc1ccccc1	"spice, waxy, floral, sweet, honey, almond"
Dimethyl Succinate	COC(=O)CCC(=O)OC	"floral, sweet, fruity, green"
Methyl Levulinate	COC(=O)CCC(C)=O	caramellic
Methyl 4-Methylvalerate	COC(=O)CCC(C)C	None
Methyl 3-Phenylpropionate	COC(=O)CCc1ccccc1	"wine, floral, fruity, honey, balsam"
Dimethyl Adipate	COC(=O)CCCCC(=O)OC	"nutty, mild"
Methyl 10-Undecenoate	COC(=O)CCCCCCCCC=C	"citrus, rose, waxy, fatty, earthy, fungal, floral, soapy"
Methyl 4-(Methylthio)Butyrate	COC(=O)CCCSC	"cabbage, pineapple, sulfury, fruity, cheese"
Methyl 3-(Methylthio)Propionate	COC(=O)CCSC	"sulfurous, garlic, onion, vegetable, tomato, sweet"
Methyl (Methylthio)Acetate	COC(=O)CSC	"roasted, nut, potato, fruity, tropical, cooked potato, roasted nut, cooked"
Methyl Acetate	COC(C)=O	"sweet, bitter, ether, fruity"
"1,1-Dimethoxyethane"	COC(C)OC	"alcohol, ether, sharp, new mown hay, sweet, green"
Hydroxycitronellal Dimethyl Acetal	COC(CC(C)CCCC(C)(C)O)OC	"lily, rose acetate, waxy, green"
"(2,2-Dimethoxyethyl)Benzene"	COC(Cc1ccccc1)OC	"hyacinth, mushroom, earthy, green, rosy, foliage, floral, bitter"
Mgombg	COC(CCCOC1C(O)C(O)C(OC)OC1CO)OC2OC(OC)C(O)C(O)C2O	sweet
67674-46-8	COC(OC)C(C)(C)CC=C(C)C	"grapefruit peel, citrus, fresh, woody, soapy, violet, green"
2-Phenylpropionaldehyde Dimethyl Acetal	COC(OC)C(C)c1ccccc1	"leafy, floral, earthy, walnut, hyacinth, mushroom, green"
Benzaldehyde Dimethyl Acetal	COC(OC)c1ccccc1	"wine, sharp, floral, hummus, fruity, almond, green"
Thymol Methyl Ether	COC.CC(C)c1ccc(C)cc1O	"smoky, woody, burnt"
6-O-Methylglucose	COC[C@@H](O)[C@@H](O)[C@H](O)[C@@H](O)C=O	sweet
"2,3,4,6-Tetra-O-Methyl-Alpha-D-Glucose"	COC[C@H]1O[C@H](O)[C@H](OC)[C@@H](OC)[C@@H]1OC	sweet
4077-47-8	COC1=C(C)OC(C)C1=O	"caramel, moldy, potato, grape, sweet, fruity, maple, mildew, mossy, mushroom"
Quassin	COC1=C[C@@H](C)[C@@H]2C[C@H]3OC(=O)C[C@H]4C(=C(OC)C(=O)[C@@H]([C@@]34C)[C@@]2(C)C1=O)C	bitter
Quassin	COC1=C[C@@H](C)[C@@H]2C[C@H]3OC(=O)C[C@H]4C(=C(OC)C(=O)[C@@H]([C@@]34C)[C@@]2(C)C1=O)C	bitter
Neoquassin	COC1=C[C@@H](C)[C@@H]2C[C@H]3OC(O)C[C@H]4C(=C(OC)C(=O)[C@@H]([C@@]34C)[C@@]2(C)C1=O)C	bitter
Colchicine	COC1=CC=C2C(=CC1=O)[C@H](CCc3cc(OC)c(OC)c(OC)c23)NC(C)=O	bitter
1-Methoxycyclohexene	COC1=CCCCC1	"spice, herb"
"4H-1-Benzopyran-4-One, 2-(3,4-Dihydroxyphenyl)-7-(Beta-D-Glucopyranosyloxy)-2,3-Dihydro-5-Methoxy-6-Methyl-, (S)-"	COc1c(C)c(O[C@@H]2O[C@H](CO)[C@@H](O)[C@H](O)[C@H]2O)cc3O[C@@H](CC(=O)c13)c4ccc(O)c(O)c4	sweet-like
Dillapiole	COc1c(CC=C)cc2OCOc2c1OC	"wood, spice"
Nepitrin	COc1c(O)c2C(=O)C=C(Oc2cc1O[C@@H]3O[C@H](CO)[C@@H](O)[C@H](O)[C@H]3O)c4ccc(O)c(O)c4	sweet-like
Periplocymarin	COC1C[C@@H](OC(C)[C@H]1O)O[C@@H]2CC[C@]3(C)C4CC[C@]5(C)[C@H](CC[C@]5(O)C4CC[C@]3(O)C2)C6=CC(=O)OC6	bitter
Khellin	COc1c2occc2c(OC)c3C(=O)C=C(C)Oc13	bitter
Methoxsalen	COc1c2occc2cc3C=CC(=O)Oc13	bitter
Beta-Terpineol	COc1cc(/C=C/CO)cc(OC)c1O[C@@H]2O[C@H](CO)[C@@H](O)[C@H](O)[C@H]2O	"must, earthy, pungent, woody"
2-Methoxy-4-Methyl-1-(Propan-2-Yl)Cyclohexane	COC1CC(C)CCC1C(C)C	minty
2-Methoxy-4-Methylphenol	COc1cc(C)ccc1O	"phenolic, clove, leather, smoky, bacon, medical, mesquite, carnation, medicinal, bitter, vanilla, spice"
Mepirizole	COc1cc(C)nc(n1)n2nc(C)cc2OC	bitter
2-Methoxy-4-Vinylphenol	COc1cc(C=C)ccc1O	"curry, smoky, clove, peanut, spicy"
Dehydrodivanillin	COc1cc(C=O)cc(c1O)c2cc(C=O)cc(OC)c2O	"vanilla, fruity"
Syringaldehyde	COc1cc(C=O)cc(OC)c1O	"mild, sweet, woody, tonka, plastic"
Vanillin	COc1cc(C=O)ccc1O	"vanilla, chocolate, sweet, creamy"
4-Formyl-2-Methoxyphenyl Acetate	COc1cc(C=O)ccc1OC(C)=O	"powdery, vanilla, sweet, creamy, heliotropin"
Apiole	COc1cc(CC=C)c(OC)c2OCOc12	"parsley, faint"
Elemicin	COc1cc(CC=C)cc(OC)c1OC	"flower, spice"
Myristicin	COc1cc(CC=C)cc2OCOc12	"balsamic, spice, warm, woody, balsam"
Eugenol	COc1cc(CC=C)ccc1O	"clove, sweet, woody, honey, spicy, cinnamon"
Eugenyl Benzoate	COc1cc(CC=C)ccc1OC(=O)c2ccccc2	"clove, balsam, mild"
Acetyleugenol	COc1cc(CC=C)ccc1OC(C)=O	"carnation, spice, clove, malt, fresh, floral, woody, sweet"
Eugenyl Formate	COc1cc(CC=C)ccc1OC=O	"orris, dry, woody, warm"
Homovanillin	COc1cc(CC=O)ccc1O	"floral, vanilla"
Trimethoprim	COc1cc(Cc2cnc(N)nc2N)cc(OC)c1OC	bitter
Vanillylacetone	COc1cc(CCC(C)=O)ccc1O	"vanilla, clove, animal, sweet, ginger, woody, spicy, phenolic"
Carvacryl Methyl Ether	COc1cc(ccc1C)C(C)C	"leafy, herbal, spicy"
Homoeriodictyol	COc1cc(ccc1O)[C@@H]2CC(=O)c3c(O)cc(O)cc3O2	bitter
Acetovanillone	COc1cc(ccc1O)C(C)=O	"vanilla, sweet, vanillin, faint"
Vanillic Acid	COc1cc(ccc1O)C(O)=O	"powdery, vanilla, bean, milky, sweet, creamy, dairy"
Silibinin	COc1cc(ccc1O)C2Oc3cc(ccc3OC2CO)C4Oc5cc(O)cc(O)c5C(=O)C4O	bitter
"2-Methoxy-4-(4-Methyl-1,3-Dioxolan-2-Yl)Phenol"	COc1cc(ccc1O)C2OCC(C)O2	"chocolate, powdery, vanilla, sweet, creamy, dairy"
Vanillyl Alcohol	COc1cc(CO)ccc1O	"vanilla, sweet, anise, creamy, balsam, tonka, phenolic"
Xanthoxylin	COc1cc(O)c(C(C)=O)c(OC)c1	"camphor, borneol"
"5,7-Dimethoxyflavone"	COc1cc(OC)c2C(=O)C=C(Oc2c1)c3ccccc3	bitter
N-Methylocoteamine	COc1cc2CCN(C)[C@H]3Cc4ccc(Oc5cc(C[C@H]6N(C)CCc7cc(OC)c(OCc(c1O)c23)cc67)ccc5O)cc4	bitter
Brucinum	COc1cc2N3C4[C@@H]5C(CC3=O)OCC=C6CN7CC[C@]4([C@@H]7C[C@H]56)c2cc1OC	bitter
"4H-1-Benzopyran-4-One, 2-(3,4-Dihydroxyphenyl)-6-((O-Beta-D-Galactopyranosyl-Beta-D-Glucopyranosyl)Oxy)-5-Hydroxy-7-Methoxy-"	COc1cc2OC(=CC(=O)c2c(O)c1O[C@@H]3O[C@H](CO)[C@@H](O)[C@H](O)[C@H]3O[C@@H]4O[C@H](CO)[C@H](O)[C@H](O)[C@H]4O)c5ccc(O)c(O)c5	sweet-like
Cirsimarin	COc1cc2OC(=CC(=O)c2c(O)c1OC)c3ccc(O[C@@H]4O[C@H](CO)[C@@H](O)[C@H](O)[C@H]4O)cc3	sweet-like
Sarisan	COc1cc2OCOc2cc1CC=C	"pepper, spice"
4-Methylanisole	COc1ccc(C)cc1	"powdery, cresol, naphthyl, camphoraceous, nutty, ylang, cedar"
"2,4-Dimethylanisole"	COc1ccc(C)cc1C	"herbal, spicy"
4-Methoxystyrene	COc1ccc(C=C)cc1	sweet
"3,4-Dimethoxystyrene"	COc1ccc(C=C)cc1OC	"cortex, floral, fruity, weedy, green"
2-Hydroxy-4-Methoxybenzaldehyde	COc1ccc(C=O)c(O)c1	vanillin
4-Methoxybenzaldehyde	COc1ccc(C=O)cc1	"mimosa, hawthorn, cherry, powdery, bitter, vanilla, anise, hawthorne, chocolate, balsam, creamy, minty, berry, sweet, floral, mint, almond, cinnamon"
"3,4-Dimethoxybenzaldehyde"	COc1ccc(C=O)cc1OC	"caramel, vanilla, creamy, sweet, woody, cherry, minty"
4-Methoxyphenylacetone	COc1ccc(CC(C)=O)cc1	"anisic, sweet, fruity, balsam, spicy"
Estragole	COc1ccc(CC=C)cc1	"licorice, spice, vanilla, alcohol, herbal, fennel, sassafrass, sweet, anise, minty, green"
Methyleugenol	COc1ccc(CC=C)cc1OC	"coconut, sweet, balsam, mesquite, clove, peach, anise, musty, creamy, carnation, bitter, oily, spicy, chocolate, warm, raspberry, spice, apricot, vanilla, banana, cinnamon, fresh, plum"
4'-Methoxyacetophenone	COc1ccc(cc1)C(C)=O	"butter, anisic, powdery, sweet, balsamic, hawthorn, caramel, acacia, bitter, vanilla"
4-Methoxybenzoic Acid	COc1ccc(cc1)C(O)=O	"putrid, sweet, faint, cadaverous"
Tangeretin	COc1ccc(cc1)C2=CC(=O)c3c(OC)c(OC)c(OC)c(OC)c3O2	bitter
"4',5,7-Trimethoxyflavone"	COc1ccc(cc1)C2=CC(=O)c3c(OC)cc(OC)cc3O2	bitter
Anethole Trithione	COc1ccc(cc1)C2=CC(=S)SS2	bitter
"4',7-Dimethoxyisoflavone"	COc1ccc(cc1)C2=COc3cc(OC)ccc3C2=O	bitter
2-Methoxy-5-Nitroaniline	COc1ccc(cc1N)[N+]([O-])=O	sweet-like
Hesperetin	COc1ccc(cc1O)[C@@H]2CC(=O)c3c(O)cc(O)cc3O2	bitter
Eriodictiol-7-Glucoside	COc1ccc(cc1O)[C@@H]2CC(=O)c3c(O)cc(O[C@@H]4O[C@H](CO)[C@@H](O)[C@H](O)[C@H]4O)cc3O2	sweet-like
Neohesperidin	COc1ccc(cc1O)[C@@H]2CC(=O)c3c(O)cc(O[C@@H]4O[C@H](CO)[C@@H](O)[C@H](O)[C@H]4O[C@@H]5O[C@@H](C)[C@H](O)[C@@H](O)[C@H]5O)cc3O2	sweet-like
Hesperidin	COc1ccc(cc1O)[C@@H]2CC(=O)c3c(O)cc(O[C@@H]4O[C@H](CO[C@@H]5O[C@@H](C)[C@H](O)[C@@H](O)[C@H]5O)[C@@H](O)[C@H](O)[C@H]4O)cc3O2	sweet-like
Hesperidin	COc1ccc(cc1O)[C@@H]2CC(=O)c3c(O)cc(O[C@@H]4O[C@H](CO[C@@H]5O[C@@H](C)[C@H](O)[C@@H](O)[C@H]5O)[C@@H](O)[C@H](O)[C@H]4O)cc3O2	sweet-like
Hesperetin 7-O-Rutinoside	COc1ccc(cc1O)[C@@H]2CC(=O)c3c(O)cc(O[C@@H]4O[C@H](CO[C@@H]5O[C@@H](C)[C@H](O)[C@@H](O)[C@H]5O)[C@@H](O)[C@H](O)[C@H]4O)cc3O2	sweet-like
Hesperetin 5-O-Glucoside	COc1ccc(cc1O)[C@@H]2CC(=O)c3c(O2)cc(O)cc3O[C@@H]4O[C@H](CO)[C@@H](O)[C@H](O)[C@H]4O	sweet-like
3695-24-7	COc1ccc(cc1O)[C@H](O)C([O-])=O	None
Phyllodulcin	COc1ccc(cc1O)[C@H]2Cc3cccc(O)c3C(=O)O2	sweet
"3',4'-Dimethoxyacetophenone"	COc1ccc(cc1OC)C(C)=O	"floral, sweet, woody"
Sinensetin	COc1ccc(cc1OC)C2=CC(=O)c3c(O2)cc(OC)c(OC)c3OC	bitter
Nobiletin	COc1ccc(cc1OC)C2=CC(=O)c3c(OC)c(OC)c(OC)c(OC)c3O2	bitter
Dl-Codamine	COc1ccc(CC2N(C)CCc3cc(OC)c(O)cc23)cc1OC	bitter
Papaverine	COc1ccc(Cc2nccc3cc(OC)c(OC)cc23)cc1OC	bitter
Neohesperidin Dihydrochalcone	COc1ccc(CCC(=O)c2c(O)cc(O[C@@H]3O[C@H](CO)[C@@H](O)[C@H](O)[C@H]3O[C@@H]4O[C@@H](C)[C@H](O)[C@@H](O)[C@H]4O)cc2O)cc1O	sweet
"1-(4-{[4,5-Dihydroxy-6-(Hydroxymethyl)-3-[(3,4,5-Trihydroxy-6-Methyloxan-2-Yl)Oxy]Oxan-2-Yl]Oxy}-2,6-Dihydroxyphenyl)-3-(3-Hydroxy-4-Methoxyphenyl)Propan-1-One"	COc1ccc(CCC(=O)c2c(O)cc(OC3OC(CO)C(O)C(O)C3OC4OC(C)C(O)C(O)C4O)cc2O)cc1O	"bland, sweet-like"
4-(4-Methoxyphenyl)-2-Butanone	COc1ccc(CCC(C)=O)cc1	"dried raspberry, cassie, rose, sweet, fruity, cherry, absolute, raspberry"
4-Methoxybenzyl Alcohol	COc1ccc(CO)cc1	"caramel, chocolate, powdery, vanilla, rose, lilac, floral, sweet, honey, hawthorn, hyacinth, flower"
4-Methoxybenzyl Phenylacetate	COc1ccc(COC(=O)Cc2ccccc2)cc1	"woody, anise, honey, balsam"
4-Methoxybenzyl Acetate	COc1ccc(COC(C)=O)cc1	"powdery, coumarin, vanilla, creamy, plum, sweet, balsam, fruity, cherry, almond, tonka"
4-Methoxybenzyl Formate	COc1ccc(COC=O)cc1	"vanilla, anisic, floral, fruity, seaweed"
4-Methoxy-3-Nitroaniline	COc1ccc(N)cc1[N+]([O-])=O	sweet-like
Sulfamethoxypyridazine	COc1ccc(N[S](=O)(=O)c2ccc(N)cc2)nn1	bitter
N-(4-Methoxyphenyl)Acetamide	COc1ccc(NC(C)=O)cc1	bitter
4-Methoxyphenylurea	COc1ccc(NC(N)=O)cc1	sweet-like
4-Methoxyphenol	COc1ccc(O)cc1	"phenolic, bitter"
2-(4-Methoxyphenoxy)Propanoic Acid	COc1ccc(OC(C)C(O)=O)cc1	bland
"1,4-Dimethoxybenzene"	COc1ccc(OC)cc1	"sweet, fennel, bitter, green, new mown hay"
7-Methoxycoumarin	COc1ccc2C=CC(=O)Oc2c1	"balsam, sweet, balsamic, tonka"
Berberine	COc1ccc2cc3c4cc5OCOc5cc4CC[n+]3cc2c1OC	bitter
2-Methoxynaphthalene	COc1ccc2ccccc2c1	"orange, neroli, floral, sweet, naphthyl, blossom, acacia"
Meconin	COc1ccc2COC(=O)c2c1OC	bitter
"COLUBRINE, BETA"	COc1ccc2N3[C@H]4[C@@H]5[C@H](CC3=O)OCC=C6CN7CC[C@]4([C@@H]7C[C@H]56)c2c1	bitter
Omeprazole	COc1ccc2nc([nH]c2c1)[S](=O)Cc3ncc(C)c(OC)c3C	bitter
Quinine	COc1ccc2nccc([C@@H](O)[C@@H]3C[C@H]4CCN3C[C@@H]4C=C)c2c1	bitter
3-Methoxybenzaldehyde	COc1cccc(C=O)c1	anisic
3-Methoxybenzoic Acid	COc1cccc(c1)C(O)=O	None
"1,3-Dimethoxybenzene"	COc1cccc(OC)c1	"hazelnut, coconut, acid, neroli, nutmeg, fruity"
"2,6-Dimethoxyphenol"	COc1cccc(OC)c1O	"smoke, powdery, balsamic, smoky, bacon, phenol, woody, medicine, phenolic"
Aristolochic Acid	COc1cccc2c1cc(c3c(cc4OCOc4c23)C(O)=O)[N+]([O-])=O	bitter
Anisole	COc1ccccc1	"butter, ethereal, alcohol, gasoline, anise, cheese, phenolic"
2-Methylanisole	COc1ccccc1C	"warm, floral, earthy, sweet, nutty, flower, walnut"
2'-Methoxyacetophenone	COc1ccccc1C(C)=O	"anisic, almond, powdery, phenolic"
2-Methoxybenzoic Acid	COc1ccccc1C(O)=O	None
2-Methoxystyrene	COc1ccccc1C=C	"nutty, ether, herbal, green"
2-Methoxybenzaldehyde	COc1ccccc1C=O	"hawthorn, powdery, sweet, vanilla, almond, acetophenone, guaiacol, bitter"
Guaiacol	COc1ccccc1O	"spice, vanilla, smoky, sweet, woody, phenolic, medicine, medicinal, smoke"
"1,2-Dimethoxybenzene"	COc1ccccc1OC	"vanilla, musty, creamy, sweet, phenolic"
Guaiacyl Phenylacetate	COc1ccccc1OC(=O)Cc2ccccc2	"powdery, spice, smoky, smoked, floral, woody, honey, balsam, sausage, heavy, phenolic"
2-Methoxyphenyl Acetate	COc1ccccc1OC(C)=O	"powdery, spice, smoky, clove, walnut, sweet, woody, dry"
Guaifenesin	COc1ccccc1OCC(O)CO	bitter
2-Methoxybenzenethiol	COc1ccccc1S	"spicy, sulfurous, powdery, smoked, sweet, sausage, meaty, phenolic"
Pantoprazole	COc1ccnc(C[S](=O)c2[nH]c3cc(OC(F)F)ccc3n2)c1OC	bitter
Sulfameter	COc1cnc(N[S](=O)(=O)c2ccc(N)cc2)nc1	bitter
2-Isopropyl-6-Methoxypyrazine	COc1cncc(n1)C(C)C	None
2-Methoxypyrazine	COc1cnccn1	"nutty, sweet, cocoa"
2-Methoxy-3-Methylpyrazine	COc1nccnc1C	None
2-Isopropyl-3-Methoxypyrazine	COc1nccnc1C(C)C	"earthy, beany, pea, earth"
2-Isobutyl-3-Methoxypyrazine	COc1nccnc1CC(C)C	"spice, pepper, green pepper, bell, earth, galbanum, pea, green"
"(2R,3S,4R,5S)-2-(Hydroxymethyl)-5,6-Dimethoxyoxane-3,4-Diol"	COC1O[C@H](CO)[C@@H](O)[C@@H](O)[C@@H]1OC	sweet
Methyl D-Mannopyranoside	COC1O[C@H](CO)[C@@H](O)[C@H](O)[C@@H]1O	sweet
Methyl 3-O-Galactopyranosylmannopyranoside	COC1O[C@H](CO)[C@@H](O)[C@H](OC2O[C@H](CO)[C@H](O)[C@H](O)[C@H]2O)[C@@H]1O	sweet
Methyl 4-O-(6-Deoxy-Manno-Heptopyranosyl)Galactopyranoside	COC1O[C@H](CO)[C@H](OC2O[C@H](CCO)[C@@H](O)[C@H](O)[C@@H]2O)[C@H](O)[C@H]1O	sweet
Methyl 4-O-Galactopyranosylgalactopyranoside	COC1O[C@H](CO)[C@H](OC2O[C@H](CO)[C@H](O)[C@H](O)[C@H]2O)[C@H](O)[C@H]1O	sweet
Methylglucoside	COC1OC(CO)[C@@H](O)C(O)[C@H]1O	sweet
617-04-9	COC1OC(CO)C(O)C(O)C1O	sweet
5-Methoxy-2-Methylthiazole	COc1sc(C)nc1	"sulfurous, vegetable, cabbage, green"
Benzyl Methyl Ether	COCc1ccccc1	"ethereal, floral, metal, fruity, hyacinth, ylang, green"
2-(Methoxymethyl)Furan	COCc1occc1	"coffee, roasted"
(2-Methoxyethyl)Benzene	COCCc1ccccc1	"chrysanthemum, jasmin, rose, floral, metallic, green"
2-(2-Methoxyethoxy)-5-Nitroaniline	COCCOc1ccc(cc1N)[N+]([O-])=O	sweet-like
Methanethiol	CS	"sulfur, garlic, gasoline, decomposing cabbage"
2949-92-0	CS[S](C)(=O)=O	"sulfurous, roasted, pungent"
Dimethyl Sulfide	CSC	"sulfur, sulfurous, cabbage, onion, gasoline, vegetable, sulfury, sweet corn, tomato, radish, wild, green"
Methyl Thiocyanate	CSC#N	sulfur
S-Methyl Benzenecarbothioate	CSC(=O)c1ccccc1	"cabbage, sulfurous, garlic, potato, vegetable"
S-Methyl 2-Furancarbothioate	CSC(=O)c1occc1	"onion, milky, creamy, fried, cooked"
S-Methyl 3-Methylbutanethioate	CSC(=O)CC(C)C	"fermented, tomato, sulfury, sharp, ripe, acrid, mushroom, cheese"
S-Methyl Thioacetate	CSC(C)=O	"sulfurous, cabbage, vegetable, egg, dairy, cheese"
3-Methylthio-2-Butanone	CSC(C)C(C)=O	None
3-(Methylthio)Butyraldehyde	CSC(C)CC=O	"potato, buchu, green, musk, chip"
Thioanisole	CSc1ccccc1	"solvent, toluene, woody, spicy"
2-(Methylthio)Phenol	CSc1ccccc1O	"sulfurous, garlic, onion, egg, meaty"
2-Methyl-3-(Methylthio)Pyrazine	CSc1nccnc1C	"roasted, vegetable, meat, nutty, almond"
2-Methyl-5-(Methylthio)Furan	CSc1oc(C)cc1	"mustard, garlic, onion, sulfury, coffee, horseradish"
D-Methionine	CSCC[C@@H](N)C(O)=O	sweet
Allyl Methyl Sulfide	CSCC=C	"garlic, onion, alliaceous"
Benzyl Methyl Sulfide	CSCc1ccccc1	"burnt, roasted, pork, lamb, chicken, beef"
4-Methylthio-2-Oxobutanoic Acid	CSCCC(=O)C(O)=O	None
4-Methylthio-2-Butanone	CSCCC(C)=O	"sulfurous, potato, vegetable, tomato, earthy, fruit, sweet"
Dl-Methionine	CSCCC(N)C(O)=O	"acidic, sulfurous, mild"
3-(Methylthio)Propionaldehyde	CSCCC=O	"potato, vegetable, tomato, fishy, musty, earthy, creamy, peanut, cooked potato, beef"
4-(Methylthio)Butanal	CSCCCC=O	"garlic, cabbage"
5-(Methylsulfanyl)Pentanenitrile	CSCCCCC#N	"cabbage, broccoli"
Erucin	CSCCCCN=C=S	"cabbage, radish"
3-(Methylthio)Propyl Isothiocyanate	CSCCCN=C=S	"horseradish, earthy, vegetable, sulfurous"
3-Methylthiopropanol	CSCCCO	"sulfurous, potato, onion, vegetable, sweet, soup"
3-(Methylthio)Propyl Acetate	CSCCCOC(C)=O	"fatty, ester"
2-(Methylthio)Ethanol	CSCCO	"sulfurous, meaty"
"1,2-Bis(Methylthio)Ethane"	CSCCSC	"sulfurous, dairy"
Methylsulfanylmethanethiol	CSCS	"sulfurous, pungent"
Bis(Methylthio)Methane	CSCSC	"sulfur, sulfurous, garlic, green, horseradish, mushroom, spicy, cheese"
"2,3,5-Trithiahexane"	CSCSSC	"strong, onion, sulfurous"
Dimethyl Disulfide	CSSC	"citrus, cabbage, sulfurous, putrid, wine_like, onion, vegetable, fatty, floral, earthy, woody, fruity, herbaceous, nutty, meaty, spicy, green"
2-(Methyldithio)Isobutyraldehyde	CSSC(C)(C)C=O	"chocolate, fat, aromatic, cocoa, dark, smoke"
Methyl Phenyl Disulfide	CSSc1ccccc1	"turnup, pungent, radish"
Methyl 2-Methyl-3-Furyl Disulfide	CSSc1ccoc1C	"sulfurous, roasted, cooked meat, onion, pepper, vegetable, thiamin, peanut, beef, meaty"
Allyl Methyl Disulfide	CSSCC=C	"garlic, onion, alliaceous, green"
Benzyl Methyl Disulfide	CSSCc1ccccc1	"cabbage, sulfurous, vegetable, metallic, green"
Furfuryl Methyl Disulfide	CSSCc1occc1	"roasted, sulfury, fishy, coffee, meaty, alliaceous, smoke"
Dimethyl Trisulfide	CSSSC	"sulfur, cabbage, sulfurous, onion, fish, savory, meaty, cooked"
Allyl Methyl Trisulfide	CSSSCC=C	"garlic, onion, creamy, alliaceous"
"Tetrasulfide, Dimethyl"	CSSSSC	"sulfur, garlic, cabbage, meaty"
Ammonia	N	ammoniacal
Benzonitrile	N#Cc1ccccc1	rancid
Phenylacetonitrile	N#CCc1ccccc1	None
3-Phenylpropanenitrile	N#CCCc1ccccc1	None
Glutaronitrile	N#CCCCC#N	bitter
531-52-2	N(\N=C(N=Nc1ccccc1)\c2ccccc2)c3ccccc3	sweet-like
Glycyrrhizin	N.CC1(C)[C@H](CC[C@@]2(C)C1CC[C@]3(C)[C@@H]2C(=O)C=C4[C@@H]5C[C@](C)(CC[C@]5(C)CC[C@@]34C)C(O)=O)O[C@H]6O[C@@H]([C@@H](O)[C@H](O)[C@H]6O[C@@H]7O[C@@H]([C@@H](O)[C@H](O)[C@H]7O)C(O)=O)C(O)=O	sweet-like
Ammonium Glycyrrhizinate	N.CC1(C)C(CCC2(C)C1CCC3(C)C2C(=O)C=C4C5CC(C)(CCC5(C)CCC34C)C(O)=O)OC6OC(C(O)C(O)C6OC7OC(C(O)C(O)C7O)C(O)=O)C(O)=O	"bland, sweet-like"
68083-53-4	N.N.N.CC1(C)[C@H](CC[C@@]2(C)[C@H]1CC[C@]3(C)[C@@H]2C(=O)C=C4[C@@H]5C[C@](C)(CC[C@]5(C)CC[C@@]34C)C(O)=O)O[C@H]6O[C@@H]([C@@H](O)[C@H](O)[C@H]6O[C@@H]7O[C@@H]([C@@H](O)[C@H](O)[C@H]7O)C(O)=O)C(O)=O	sweet-like
Daramin	N.O=C1N[S](=O)(=O)c2ccccc12	sweet
L-Asparagine	N[C@@H](CC(N)=O)C(O)=O	odorless
L-Aspartyl-L-Phenylalanine	N[C@@H](CC(O)=O)C(=O)N[C@@H](Cc1ccccc1)C(O)=O	sweet
L-Aspartic Acid	N[C@@H](CC(O)=O)C(O)=O	odorless
L-Tryptophan	N[C@@H](Cc1c[nH]c2ccccc12)C(O)=O	bitter
L-Histidine	N[C@@H](Cc1c[nH]cn1)C(O)=O	"odorless, bitter"
Levodopa	N[C@@H](Cc1ccc(O)c(O)c1)C(O)=O	odorless
L-Tyrosine	N[C@@H](Cc1ccc(O)cc1)C(O)=O	odorless
Phenylalanyltryptophan	N[C@@H](Cc1ccccc1)C(=O)N[C@@H](Cc2c[nH]c3ccccc23)C(O)=O	bitter
L-Phenylalanine	N[C@@H](Cc1ccccc1)C(O)=O	"odorless, bitter"
L-Glutamine	N[C@@H](CCC(N)=O)C(O)=O	"mild, milky, oily, cocoa, custard"
L-Glutamic Acid	N[C@@H](CCC(O)=O)C(O)=O	"yeast, bread, baked, mild"
L-Arginine	N[C@@H](CCCNC(N)=N)C(O)=O	faint
L-Cysteine	N[C@@H](CS)C(O)=O	sulfury
D-Aspartic Acid	N[C@H](CC(O)=O)C(O)=O	sweet
D-Tryptophan	N[C@H](Cc1c[nH]c2ccccc12)C(O)=O	sweet
D-Histidine	N[C@H](Cc1c[nH]cn1)C(O)=O	sweet
D-Tyrosine	N[C@H](Cc1ccc(O)cc1)C(O)=O	sweet
D-Phenylalanine	N[C@H](Cc1ccccc1)C(O)=O	sweet
D-Glutamine	N[C@H](CCC(N)=O)C(O)=O	sweet
D-Serine	N[C@H](CO)C(O)=O	sweet
D-Cysteine	N[C@H](CS)C(O)=O	sweet
83305-95-7	N[P](O)(=O)ONc1ncnc2n(cnc12)[C@@H]3O[C@H](CO)[C@@H](O)[C@H]3O	sweet-like
Sulfamic Acid	N[S](O)(=O)=O	"fatty, bland"
Pentamidine Isethionate	NC(=N)c1ccc(OCCCCCOc2ccc(cc2)C(N)=N)cc1.OCC[S](O)(=O)=O.OCC[S](O)(=O)=O	bitter
Propamidine Isetionate	NC(=N)c1ccc(OCCCOc2ccc(cc2)C(N)=N)cc1.OCC[S](O)(=O)=O.OCC[S](O)(=O)=O	bitter
Phenylbiguanide	NC(=N)NC(=N)Nc1ccccc1	bitter
Prolylarginine	NC(=N)NCCC[C@H](NC(=O)[C@@H]1CCCN1)C(O)=O	bitter
Benzamide	NC(=O)c1ccccc1	bitter
Salicylamide	NC(=O)c1ccccc1O	bitter
Nicotinamide	NC(=O)c1cccnc1	odorless
(4-PHENOXYPHENYL)UREA	NC(=O)Nc1ccc(Oc2ccccc2)cc1	sweet-like
Phenprobamate	NC(=O)OCCCc1ccccc1	bitter
Dl-Phenylalanine	NC(Cc1ccccc1)C(O)=O	odorless
2-Amino-3-(Prop-2-En-1-Ylsulfanyl)Propanoic Acid	NC(CSCC=C)C(O)=O	"roasted, cooked"
Gaster	NC(N)=Nc1scc(CSCCC(N)=N[S](N)(=O)=O)n1	bitter
5'-Guanylic Acid	NC1=Nc2n(cnc2C(=O)N1)[C@@H]3O[C@H](CO[P](O)(O)=O)[C@@H](O)[C@H]3O	odorless
Folic Acid	NC1=Nc2ncc(CNc3ccc(cc3)C(=O)N[C@@H](CCC(O)=O)C(O)=O)nc2C(=O)N1	odorless
Dapsone	Nc1ccc(cc1)[S](=O)(=O)c2ccc(N)cc2	bitter
CHA-Sulfate	NC1CCCCC1.O[S](O)(=O)=O	sweet
Naphthalen-2-Yl 2-Aminobenzoate	Nc1ccccc1C(=O)Oc2ccc3ccccc3c2	"floral, neroli, grape"
Cyclohexyl Anthranilate	Nc1ccccc1C(=O)OC2CCCCC2	"neroli, orange, blossom, mild"
Allyl Anthranilate	Nc1ccccc1C(=O)OCC=C	"floral, grape, leaf, green"
Phenethyl Anthranilate	Nc1ccccc1C(=O)OCCc2ccccc2	"orange, rose, grape, floral, iris, sweet, honey"
2-Chloro-Datp	Nc1nc(Cl)nc2n(cnc12)C3CC(O)C(CO[P](O)(=O)O[P](O)(=O)O[P](O)(O)=O)O3	sweet-like
74832-57-8	Nc1nc(F)nc2n(cnc12)C3O[C@H](CO[P](O)(=O)O[P](O)(=O)O[P](O)(O)=O)[C@@H](O)[C@@H]3O	sweet-like
Fludarabine Phosphate	Nc1nc(F)nc2n(cnc12)C3OC(CO[P](O)(O)=O)C(O)C3O	sweet-like
AraDAP	Nc1nc(N)c2ncn([C@@H]3O[C@H](CO)[C@@H](O)[C@@H]3O)c2n1	sweet-like
2-Aminoadenosine	Nc1nc(N)c2ncn([C@@H]3O[C@H](CO)[C@@H](O)[C@H]3O)c2n1	sweet-like
2-Amino-2'-Deoxyadenosine 5'-(Tetrahydrogen Triphosphate)	Nc1nc(N)c2ncn([C@H]3C[C@H](O)[C@@H](CO[P](O)(=O)O[P](O)(=O)O[P](O)(O)=O)O3)c2n1	sweet-like
2-Azidoadenosine 5'-Triphosphate	Nc1nc(N=[N+]=[N-])nc2n(cnc12)[C@@H]3O[C@H](CO[P](O)(=O)O[P](O)(=O)O[P](O)(O)=O)[C@@H](O)[C@H]3O	sweet-like
2-Azido-ADP	Nc1nc(N=[N+]=[N-])nc2n(cnc12)[C@@H]3O[C@H](CO[P](O)(=O)O[P](O)(O)=O)[C@@H](O)[C@H]3O	sweet-like
Alpha-D-Arabinofuranosyladenine	Nc1nc(nc2nc[nH]c12)[C@H]3O[C@H](CO)[C@@H](O)[C@@H]3O	sweet-like
8-Aminoadenosine	Nc1nc2c(N)ncnc2n1[C@@H]3O[C@H](CO)[C@@H](O)[C@H]3O	sweet-like
Bcamp	Nc1ncnc2n([C@@H]3O[C@@H]4CO[P](O)(=O)O[C@H]4[C@H]3O)c(Br)nc12	sweet-like
8-Chloro-CAMP	Nc1ncnc2n([C@@H]3O[C@@H]4CO[P](O)(=O)O[C@H]4[C@H]3O)c(Cl)nc12	sweet-like
31966-52-6	Nc1ncnc2n([C@@H]3O[C@@H]4CO[P](O)(=O)O[C@H]4[C@H]3O)c(N=[N+]=[N-])nc12	sweet-like
92267-23-7	Nc1ncnc2n(C3C[C@H](O)[C@@H](CO[P](O)(O)=O)O3)c(Br)nc12	sweet-like
60731-47-7	Nc1ncnc2n(C3O[C@H](CO[P](O)(O)=O)[C@@H](O)[C@H]3O)c(N=[N+]=[N-])nc12	sweet-like
"8-Bromo-CAMP, Na"	Nc1ncnc2n(C3OC4CO[P](O)(=O)OC4C3O)c(Br)nc12	sweet-like
Adenosine	Nc1ncnc2n(cnc12)[C@@H]3O[C@H](CO)[C@@H](O)[C@H]3O	sweet-like
Adenosine 2'-Phosphate	Nc1ncnc2n(cnc12)[C@@H]3O[C@H](CO)[C@@H](O)[C@H]3O[P](O)(O)=O	sweet-like
"2',3'-Cyclic AMP"	Nc1ncnc2n(cnc12)[C@@H]3O[C@H](CO)[C@H]4O[P](O)(=O)O[C@@H]34	sweet-like
Adenosine 5'-Methylenediphosphate	Nc1ncnc2n(cnc12)[C@@H]3O[C@H](CO[P](O)(=O)C[P](O)(O)=O)[C@@H](O)[C@H]3O	sweet-like
Amp-Pcp	Nc1ncnc2n(cnc12)[C@@H]3O[C@H](CO[P](O)(=O)O[P](O)(=O)C[P](O)(O)=O)[C@@H](O)[C@H]3O	sweet-like
Gamma-Imino-ATP	Nc1ncnc2n(cnc12)[C@@H]3O[C@H](CO[P](O)(=O)O[P](O)(=O)N[P](O)(O)=O)[C@@H](O)[C@H]3O	sweet-like
Adenosine Tetraphosphate	Nc1ncnc2n(cnc12)[C@@H]3O[C@H](CO[P](O)(=O)O[P](O)(=O)O[P](O)(=O)O[P](O)(O)=O)[C@@H](O)[C@H]3O	sweet-like
3714-60-1	Nc1ncnc2n(cnc12)[C@@H]3O[C@H](CO[P](O)(=O)O[P](O)(=O)O[P](O)(O)=O)[C@@H](O)[C@@H]3O	sweet-like
73449-07-7	Nc1ncnc2n(cnc12)[C@@H]3O[C@H](CO[P](O)(=O)O[P](O)(=O)O[P](O)(O)=O)[C@@H](O)[C@H]3F	sweet-like
Adenosine Triphosphate	Nc1ncnc2n(cnc12)[C@@H]3O[C@H](CO[P](O)(=O)O[P](O)(=O)O[P](O)(O)=O)[C@@H](O)[C@H]3O	sweet-like
Cordycepin Triphosphate	Nc1ncnc2n(cnc12)[C@@H]3O[C@H](CO[P](O)(=O)O[P](O)(=O)O[P](O)(O)=O)C[C@H]3O	sweet-like
Adenosine 5'-Diphosphate	Nc1ncnc2n(cnc12)[C@@H]3O[C@H](CO[P](O)(=O)O[P](O)(O)=O)[C@@H](O)[C@H]3O	sweet-like
3'-Phosphate-Adenosine-5'-Diphosphate	Nc1ncnc2n(cnc12)[C@@H]3O[C@H](CO[P](O)(=O)O[P](O)(O)=O)[C@@H](O[P](O)(O)=O)[C@H]3O	sweet-like
Adenylyl Sulfate	Nc1ncnc2n(cnc12)[C@@H]3O[C@H](CO[P](O)(=O)O[S](O)(=O)=O)[C@@H](O)[C@H]3O	sweet-like
Vidarabine Monophosphate	Nc1ncnc2n(cnc12)[C@@H]3O[C@H](CO[P](O)(O)=O)[C@@H](O)[C@@H]3O	sweet-like
Poly-Fdaa	Nc1ncnc2n(cnc12)[C@@H]3O[C@H](CO[P](O)(O)=O)[C@@H](O)[C@H]3F	sweet-like
Adenosine 5'-Monophosphate	Nc1ncnc2n(cnc12)[C@@H]3O[C@H](CO[P](O)(O)=O)[C@@H](O)[C@H]3O	sweet
2'-Deoxyadenosine 5'-Triphosphate Disodium Salt(DATP)	Nc1ncnc2n(cnc12)C3CC(O)C(CO[P](O)(=O)O[P](O)(=O)O[P](O)(O)=O)O3	sweet-like
DATP	Nc1ncnc2n(cnc12)C3CC(O)C(CO[P](O)(=O)O[P](O)(=O)O[P](O)(O)=O)O3	sweet-like
DAMP	Nc1ncnc2n(cnc12)C3CC(O)C(CO[P](O)(O)=O)O3	sweet-like
9-Arabinofuranosyladenine	Nc1ncnc2n(cnc12)C3O[C@H](CO)[C@@H](O)[C@@H]3O	sweet-like
97474-27-6	Nc1ncnc2n(cnc12)C3O[C@H](CO[P](O)(=O)C(Br)[P](O)(=O)O[P](O)(O)=O)[C@@H](O)[C@H]3O	sweet-like
92117-27-6	Nc1ncnc2n(cnc12)C3O[C@H](CO[P](O)(=O)O[P](O)(=O)O[P](O)(O)=O)C(N=[N+]=[N-])[C@H]3O	sweet-like
Spectrum_000075	Nc1ncnc2n(cnc12)C3O[C@H](CO[P](O)(O)=O)[C@@H](O)[C@H]3O	sweet-like
92117-24-3	Nc1ncnc2n(cnc12)C3O[C@H](CO[P](O)(O)=O)C(N=[N+]=[N-])[C@H]3O	sweet-like
96790-49-7	Nc1ncnc2n(cnc12)C3O[C@H](CO[P]4(=O)NCCCO4)[C@@H](O)[C@@H]3O	sweet-like
3228-71-5	Nc1ncnc2n(cnc12)C3OC(CO)C(O)C3O	sweet-like
Vidarabine	Nc1ncnc2n(cnc12)C3OC(CO)C(O)C3O	sweet-like
Vidarabine	Nc1ncnc2n(cnc12)C3OC(CO)C(O)C3O	sweet-like
Synadenylic Acid	Nc1ncnc2n(cnc12)C3OC(CO)C(O[P](O)(O)=O)C3O	sweet-like
"4-(6-Amino-9h-Purin-9-Yl)-6-(Hydroxymethyl)Tetrahydrofuro[3,4-D][1,3,2]Dioxaphosphol-2-Ol 2-Oxide"	Nc1ncnc2n(cnc12)C3OC(CO)C4O[P](O)(=O)OC34	sweet-like
NSC614641	Nc1ncnc2n(cnc12)C3OC(CO[P](O)(=O)C[P](O)(O)=O)C(O)C3O	sweet-like
58337-43-2	Nc1ncnc2n(cnc12)C3OC(CO[P](O)(=O)O[P](O)(=O)O[P](O)(=O)O[P](O)(O)=O)C(O)C3O	sweet-like
Paps	Nc1ncnc2n(cnc12)C3OC(CO[P](O)(=O)O[S](O)(=O)=O)C(O[P](O)(O)=O)C3O	sweet-like
NSC20264	Nc1ncnc2n(cnc12)C3OC(CO[P](O)(O)=O)C(O)C3O	sweet-like
"Adenosine 3',5'-Bisphosphate"	Nc1ncnc2n(cnc12)C3OC(CO[P](O)(O)=O)C(O[P](O)(O)=O)C3O	sweet-like
NSC94017	Nc1ncnc2n(cnc12)C3OC4CO[P](O)(=O)OC4C3O	sweet-like
CAMP	Nc1ncnc2n(cnc12)C3OC4CO[P](O)(=O)OC4C3O	sweet-like
2-Amino-5-Nitrothiazole	Nc1sc(cn1)[N+]([O-])=O	bitter
Glycyl-L-Phenylalanine	NCC(=O)N[C@@H](Cc1ccccc1)C(O)=O	bitter
Gly-Ser-Phe	NCC(=O)N[C@@H](CO)C(=O)N[C@@H](Cc1ccccc1)C(O)=O	sweet
Glycine	NCC(O)=O	"oily, odorless, sweet, fatty, waxy"
Taurine	NCC[S](O)(=O)=O	"bland, bitter"
Beta-Alanine	NCCC(O)=O	"sweet, odorless"
Tyramine	NCCc1ccc(O)cc1	"mild, rubbery, meaty, dirty, cooked, phenolic"
Phenethylamine	NCCc1ccccc1	"ammoniacal, fishy"
"2,5-Diaminopentanoic Acid"	NCCCC(N)C(O)=O	"bark, green, mild"
4-Aminobutyric Acid	NCCCC(O)=O	"savory, meaty"
D-Lysine	NCCCC[C@@H](N)C(O)=O	sweet
Lysylphenylalanine	NCCCC[C@H](N)C(=O)N[C@@H](Cc1ccccc1)C(O)=O	sweet
L-Lysine	NCCCC[C@H](N)C(O)=O	odorless
Spermine	NCCCNCCCCNCCCN	None
Water	O	odorless
Diphenyl Oxide	O(c1ccccc1)c2ccccc2	"geranium, phenolic, green, leaf"
Calcium Hydrate	O.[CaH2]	"odorless, bitter"
Calcium Saccharin Hydrate	O.[CaH2].O=C1N[S](=O)(=O)c2ccccc12	sweet
Lincomycin Hydrochloride Monohydrate	O.[Cl-].CCC[C@@H]1C[C@H](N(C)C1)C(=O)N[C@H]([C@@H](C)O)[C@H]2O[C@H](SC)[C@H](O)[C@@H](O)[C@H]2O.[H+]	bitter
Adenosine 5'-Triphosphate Disodium Salt	O.[Na].Nc1ncnc2n(cnc12)C3OC(CO[P](O)(=O)O[P](O)(=O)O[P](O)(O)=O)C(O)C3O	sweet-like
Terpin Hydrate	O.CC(C)(O)C1CCC(C)(O)CC1	bitter
Dexofen	O.CCC(=O)O[C@@](Cc1ccccc1)([C@H](C)CN(C)C)c2ccccc2.O[S](=O)(=O)c3ccc4ccccc4c3	bitter
Cyclamate Calcium Dihydrate	O.O.[Ca++].[O-][S](=O)(=O)NC1CCCCC1.[O-][S](=O)(=O)NC2CCCCC2	sweet
Quinine Sulfate	O.O.COc1ccc2nccc([C@@H](O)[C@@H]3CC4CCN3C[C@@H]4C=C)c2c1.COc5ccc6nccc([C@@H](O)[C@@H]7CC8CCN7C[C@@H]8C=C)c6c5.O[S](O)(=O)=O	bitter
Quinine Sulfate Dihydrate	O.O.COc1ccc2nccc([C@@H](O)[C@@H]3CC4CCN3C[C@@H]4C=C)c2c1.COc5ccc6nccc([C@@H](O)[C@@H]7CC8CCN7C[C@@H]8C=C)c6c5.O[S](O)(=O)=O	None
Alitame	O.O.O.O.O.C[C@@H](NC1C(C)(C)SC1(C)C)C(=O)NC(=O)[C@@H](N)CC(O)=O.C[C@@H](NC2C(C)(C)SC2(C)C)C(=O)NC(=O)[C@@H](N)CC(O)=O	sweetbitter
Magnesium Sulfate Heptahydrate	O.O.O.O.O.O.O.[Mg++].[O-][S]([O-])(=O)=O	bitter
Potassium Alum	O.O.O.O.O.O.O.O.O.O.O.O.[Al+3].[K+].[O-][S]([O-])(=O)=O.[O-][S]([O-])(=O)=O	odorless
Lactitol Dihydrate	O.O.OC[C@H](O)[C@@H](O)[C@H](O[C@@H]1O[C@H](CO)[C@H](O)[C@H](O)[C@H]1O)[C@H](O)CO	sweet
"Galacturonic Acid, D-"	O[C@@H](C=O)[C@@H](O)[C@@H](O)[C@H](O)C(O)=O	sweet
15769-56-9	O[C@@H](C=O)[C@H](O)[C@@H](O)[C@H](O)C(O)=O	sweet
(-)-Epigallocatechin	O[C@@H]1Cc2c(O)cc(O)cc2O[C@@H]1c3cc(O)c(O)c(O)c3	bitter
(-)-Epicatechin	O[C@@H]1Cc2c(O)cc(O)cc2O[C@@H]1c3ccc(O)c(O)c3	bitter
Beta-D-Xylopyranose	O[C@@H]1CO[C@@H](O)[C@H](O)[C@H]1O	sweet
"4H-1-Benzopyran-4-One, 2-(3,4-Dihydroxyphenyl)-2,3-Dihydro-5-Hydroxy-7-((4-O-Beta-D-Xylopyranosyl-Beta-D-Arabinopyranosyl)Oxy)-, (S)-"	O[C@@H]1CO[C@@H](O[C@@H]2CO[C@@H](Oc3cc(O)c4C(=O)C[C@H](Oc4c3)c5ccc(O)c(O)c5)[C@@H](O)[C@@H]2O)[C@H](O)[C@H]1O	sweet-like
Alpha-D-Xylopyranose	O[C@@H]1CO[C@H](O)[C@H](O)[C@H]1O	sweet
D-Arabinopyranose	O[C@@H]1COC(O)[C@@H](O)[C@@H]1O	sweet
Cinchonine	O[C@H]([C@H]1C[C@@H]2CCN1C[C@@H]2C=C)c3ccnc4ccccc34	bitter
6814-36-4	O[C@H](C=O)[C@@H](O)[C@H](O)[C@H](O)C(O)=O	sweet
D-Iduronic Acid	O[C@H](C=O)[C@H](O)[C@@H](O)[C@H](O)C(O)=O	sweet
Altruronic Acid	O[C@H](C=O)[C@H](O)[C@H](O)[C@H](O)C(O)=O	sweet
Glucose 6-Arsenate	O[C@H](CO[As](O)(O)=O)[C@@H](O)[C@H](O)[C@@H](O)C=O	sweet
Glucose 6-(Hydrogen Sulfate)	O[C@H](CO[S](O)(=O)=O)[C@@H](O)[C@H](O)[C@@H](O)C=O	sweet
Mannose 6-Sulfate	O[C@H](CO[S](O)(=O)=O)[C@@H](O)[C@H](O)[C@H](O)C=O	sweet
Galactose 6-Sulfate	O[C@H](CO[S](O)(=O)=O)[C@H](O)[C@H](O)[C@@H](O)C=O	sweet
Inosinic Acid	O[C@H]1[C@@H](O)[C@@H](O[C@@H]1CO[P](O)(O)=O)n2cnc3C(=O)N=CNc23	odorless
Gallocatechin	O[C@H]1Cc2c(O)cc(O)cc2O[C@@H]1c3cc(O)c(O)c(O)c3	bitter
Cianidanol	O[C@H]1Cc2c(O)cc(O)cc2O[C@@H]1c3ccc(O)c(O)c3	bitter
Pentopyranose	O[C@H]1CO[C@@H](O)[C@H](O)[C@@H]1O	sweet
2564-86-5	O[C]=O	None
Phosphoric Acid	O[P](O)(O)=O	bland
Antazoline Phosphate	O[P](O)(O)=O.C1CN=C(CN(Cc2ccccc2)c3ccccc3)N1	bitter
"1,2-Benzisothiazole-4-Sulfonic Acid, 2,3-Dihydro-3-Oxo-, 1,1-Dioxide"	O[S](=O)(=O)c1cccc2c1C(=O)N[S]2(=O)=O	sweet
Cyclamic Acid	O[S](=O)(=O)NC1CCCCC1	sweet
Calcium Oxide	O=[Ca]	odorless
Magnesium Oxide	O=[Mg]	odorless
Sulfur Dioxide	O=[S]=O	bitter
Silica	O=[Si]=O	odorless
Zinc Oxide	O=[Zn]	odorless
Benzophenone	O=C(c1ccccc1)c2ccccc2	"peach, powdery, apricot, rose, balsam, geranium, metallic"
Dicyclohexyl Ketone	O=C(C1CCCCC1)C2CCCCC2	None
"1,3-Diphenylacetone"	O=C(Cc1ccccc1)Cc2ccccc2	"benzaldehyde, bitter, plastic, almond, seedy"
Benzyl Phenylacetate	O=C(Cc1ccccc1)OCc2ccccc2	"jasmin, floral, sweet, cocoa, honey"
Phenethyl Phenylacetate	O=C(Cc1ccccc1)OCCc2ccccc2	"rose, floral, sweet, honey, balsam, hyacinth"
Nialamide	O=C(CCNNC(=O)c1ccncc1)NCc2ccccc2	bitter
Benzyl Benzoate	O=C(OCc1ccccc1)c2ccccc2	"oil, pineapple, balsamic, herbal, strawberry, oily, faint, sweet, balsam, cherry, almond, herb, cheese"
Phenethyl Benzoate	O=C(OCCc1ccccc1)c2ccccc2	"soft, rose, floral, honey, balsam"
Hydrocinnamyl Cinnamate	O=C(OCCCc1ccccc1)C=Cc2ccccc2	None
Benzoyl Peroxide	O=C(OOC(=O)c1ccccc1)c2ccccc2	"benzaldehyde, mild"
Carbon Dioxide	O=C=O	odorless
Isoflavone	O=C1C(=COc2ccccc12)c3ccccc3	bitter
Flavone	O=C1C=C(Oc2ccccc12)c3ccccc3	bitter
P-Benzoquinone	O=C1C=CC(=O)C=C1	None
Xanthone	O=C1c2ccccc2Oc3ccccc13	bitter
Flavanone	O=C1CC(Oc2ccccc12)c3ccccc3	bitter
Dihydrocoumarin	O=C1CCc2ccccc2O1	"coconut, tobacco, coumarin, herbal, creamy, sweet, cinnamon, almond, tonka"
Octahydrocoumarin	O=C1CCC2CCCCC2O1	"coumarin, herbal, sweet, woody, tonka"
2-Cyclohexen-1-One	O=C1CCCC=C1	"savory, roasted, green, pesticide"
Cyclopentanone	O=C1CCCC1	minty
Alpha-Tetralone	O=C1CCCc2ccccc12	bitter
Cyclohexanone	O=C1CCCCC1	"minty, acetone"
"1,2-Cyclohexanedione"	O=C1CCCCC1=O	"caramel, acorn, sweet, brothy, maple, nut skin"
Cyclooctanone	O=C1CCCCCCC1	bitter
Ethylene Brassylate	O=C1CCCCCCCCCCCC(=O)OCCO1	"powdery, musky, floral, musty, sweet, ambrette, musk, woody"
"1,7-Dioxacycloheptadecan-8-One"	O=C1CCCCCCCCCOCCCCCO1	musky
Azepan-2-One	O=C1CCCCCN1	"spicy, bitter, amine"
2-Pyrrolidinone	O=C1CCCN1	None
Gamma-Butyrolactone	O=C1CCCO1	"caramel, oily, fatty, sweet, creamy"
Thiolan-2-One	O=C1CCCS1	"garlic, burnt"
Tetrahydrothiophen-3-One	O=C1CCSC1	"butter, garlic, vegetable, clam, buttery, meaty, green"
Saccharin	O=C1N[S](=O)(=O)c2ccccc12	"odorless, bitter, sweet"
2634-33-5	O=C1NSc2ccccc12	sweet
Coumarin	O=C1Oc2ccccc2C=C1	"sweet, new mown hay, green, tonka, bitter"
2(5H)-Furanone	O=C1OCC=C1	buttery
Phthalide	O=C1OCc2ccccc12	"coconut, lactonic, powdery, coumarin, sweet, phenolic, tonka"
1H-Pyrrole-2-Carbaldehyde	O=Cc1[nH]ccc1	ethereal
Piperonal	O=Cc1ccc2OCOc2c1	"coconut, heliotrope, powdery, sweet, vanilla, flower, violet, bitter"
Benzaldehyde	O=Cc1ccccc1	"cherry, almond, sweet, burnt sugar, sharp, strong, bitter"
4265-16-1	O=Cc1oc2ccccc2c1	"almond, bitter"
2-Furaldehyde	O=Cc1occc1	"fragrant, bread, woody, sweet, baked, almond"
Thiophene-2-Carbaldehyde	O=Cc1sccc1	"sulfur, sulfurous"
Phenylacetaldehyde	O=CCc1ccccc1	"hyacinth, honey, clover, sweet, hawthorne, cocoa, grapefruit, green, peanut, floral, bitter"
3-Phenylpropanal	O=CCCc1ccccc1	"chocolate, cortex, clove, foliage, strawberry, fresh, green, honey, balsam, leaf, hyacinth, storax, cinnamon"
Glutaraldehyde	O=CCCCC=O	"pungent, fruity, medicinal"
Cyclohexyl Formate	O=COC1CCCCC1	"cooling, jam, ethereal, banana, sweet, fruity, cherry"
Benzyl Formate	O=COCc1ccccc1	"pineapple, apricot, floral, fruity, cranberry, almond, black tea, spicy"
2-Phenylethyl Formate	O=COCCc1ccccc1	"hyacinth, rose, green, herbal, watercress, bitter"
3-Phenylpropyl Formate	O=COCCCc1ccccc1	"floral, sweet, honey, hyacinth, cinnamon"
L-Pyroglutamic Acid	OC(=O)[C@@H]1CCC(=O)N1	"ethereal, sweet, mild"
L-Proline	OC(=O)[C@@H]1CCCN1	odorless
D-Proline	OC(=O)[C@H]1CCCN1	sweet
Phenylpyruvic Acid	OC(=O)C(=O)Cc1ccccc1	"almond, acidic, green, sweet, honey, weedy, phenolic"
Benzilic Acid	OC(=O)C(O)(c1ccccc1)c2ccccc2	bitter
Oxalic Acid	OC(=O)C(O)=O	None
56633-51-3	OC(=O)C[C@H](NC=O)C(=O)N[C@@H](Cc1ccccc1)C(O)=O	sweet
Ciprofloxacin	OC(=O)C1=CN(C2CC2)c3cc(N4CCNCC4)c(F)cc3C1=O	bitter
Oxycinchophen	OC(=O)c1c(O)c(nc2ccccc12)c3ccccc3	odorless
"5,5'-Methylenedisalicylic Acid"	OC(=O)c1cc(Cc2ccc(O)c(c2)C(O)=O)ccc1O	bitter
"3,5-Diiodosalicylic Acid"	OC(=O)c1cc(I)cc(I)c1O	bitter
Cinchophen	OC(=O)c1cc(nc2ccccc12)c3ccccc3	bitter
Gallic Acid	OC(=O)c1cc(O)c(O)c(O)c1	bitter
"3,4-Dinitrobenzoic Acid"	OC(=O)c1ccc(c(c1)[N+]([O-])=O)[N+]([O-])=O	bitter
"3,4-Dihydroxybenzoic Acid"	OC(=O)c1ccc(O)c(O)c1	"phenolic, balsamic, mild"
4-Hydroxybenzoic Acid	OC(=O)c1ccc(O)cc1	"nutty, phenolic"
"2,4-Dihydroxybenzoic Acid"	OC(=O)c1ccc(O)cc1O	"phenolic, mild"
Piperonylic Acid	OC(=O)c1ccc2OCOc2c1	bitter
"1,8-Naphthalaldehydic Acid"	OC(=O)c1cccc2cccc(C=O)c12	bitter
1-Naphthoic Acid	OC(=O)c1cccc2ccccc12	bitter
Benzoic Acid	OC(=O)c1ccccc1	"balsam, urine, faint"
Cyclohexanecarboxylic Acid	OC(=O)C1CCCCC1	"acidic, tropical, fruity, metallic, cheese"
Phthalylsulfathiazole	OC(=O)c1ccccc1C(=O)Nc2ccc(cc2)[S](=O)(=O)Nc3sccn3	bitter
2-(Benzoylamino)Benzoic Acid	OC(=O)c1ccccc1NC(=O)c2ccccc2	fruity
Flufenamic Acid	OC(=O)c1ccccc1Nc2cccc(c2)C(F)(F)F	bitter
Salicylic Acid	OC(=O)c1ccccc1O	"nutty, faint, phenolic"
Salsalate	OC(=O)c1ccccc1OC(=O)c2ccccc2O	bitter
Niflumic Acid	OC(=O)c1cccnc1Nc2cccc(c2)C(F)(F)F	bitter
Benzofuran-2-Carboxylic Acid	OC(=O)c1oc2ccccc2c1	bitter
2-Furoic Acid	OC(=O)c1occc1	odorless
Aconitic Acid	OC(=O)CC(=CC(O)=O)C(O)=O	"musty, nutty, very mild"
Citric Acid	OC(=O)CC(O)(CC(O)=O)C(O)=O	odorless
Indole-3-Acetic Acid	OC(=O)Cc1c[nH]c2ccccc12	"sour, odorless, mild"
Phenylacetic Acid	OC(=O)Cc1ccccc1	"honeysuckle, sour, waxy, floral, sweet, honey, civet, flower"
Cyclohexylacetic Acid	OC(=O)CC1CCCCC1	"caramel, powdery, jasmine, acetic, sharp, fatty, musty, honey, cheese"
Diclofenac	OC(=O)Cc1ccccc1Nc2c(Cl)cccc2Cl	bitter
2-Ketoglutaric Acid	OC(=O)CCC(=O)C(O)=O	odorless
Succinic Acid	OC(=O)CCC(O)=O	"sour, odorless"
4-Pentenoic Acid	OC(=O)CCC=C	"parmesan, ricotta, romano, cheese"
3-Phenylpropanoic Acid	OC(=O)CCc1ccccc1	"balsamic, rose, fatty, sweet, musk, cinnamon"
Glutaric Acid	OC(=O)CCCC(O)=O	odorless
Adipic Acid	OC(=O)CCCCC(O)=O	odorless
9-Decenoic Acid	OC(=O)CCCCCCCC=C	"waxy, fatty, fruity, soapy, green"
10-Undecenoic Acid	OC(=O)CCCCCCCCC=C	"sweet, woody"
11-Dodecenoic Acid	OC(=O)CCCCCCCCCC=C	"fatty, citrus"
3-Mercaptopropionic Acid	OC(=O)CCS	"sulfurous, roasted"
Phenoxyacetic Acid	OC(=O)COc1ccccc1	"sour, sweet"
DL-Tartaric Acid	OC(C(O)C(O)=O)C(O)=O	"caramellic, very mild"
Cinchonidine	OC(C1CC2CCN1CC2C=C)c3ccnc4ccccc34	bitter
Benzoin	OC(c1ccccc1)C(=O)c2ccccc2	"medicinal, vanilla, bitter, medical"
Difenidol	OC(CCCN1CCCCC1)(c2ccccc2)c3ccccc3	bitter
Acide Cromoglicique [INN-French]	OC(COc1ccc2OC(=CC(=O)c2c1)C(O)=O)COc3cccc4OC(=CC(=O)c34)C(O)=O	bitter
Chloral Hydrate	OC(O)C(Cl)(Cl)Cl	bitter
Beta-D-Fructopyranose	OC[C@@]1(O)OC[C@@H](O)[C@@H](O)[C@@H]1O	sweet
D-(+)-ALLOSE	OC[C@@H](O)[C@@H](O)[C@@H](O)[C@@H](O)C=O	sweet
Hexitol	OC[C@@H](O)[C@@H](O)[C@@H](O)[C@@H](O)CO	sweet
Allitol	OC[C@@H](O)[C@@H](O)[C@@H](O)[C@@H](O)CO	sweet
Glycero-Manno-Heptose	OC[C@@H](O)[C@@H](O)[C@@H](O)[C@H](O)[C@H](O)C=O	sweet
Erythrohexulose	OC[C@@H](O)[C@@H](O)[C@@H](O)C(=O)CO	sweet
2535-38-8	OC[C@@H](O)[C@@H](O)[C@](O)([C@@H](O)C=O)[3H]	sweet
3-Deoxy-3-Fluoro-D-Glucose	OC[C@@H](O)[C@@H](O)[C@H](F)[C@@H](O)C=O	sweet
3-Deoxy-3-Iodo-D-Glucose	OC[C@@H](O)[C@@H](O)[C@H](I)[C@@H](O)C=O	sweet
D-Glycero-D-Gulo-Heptose	OC[C@@H](O)[C@@H](O)[C@H](O)[C@@H](O)[C@@H](O)C=O	sweet
D-Gluco-2-Heptulose	OC[C@@H](O)[C@@H](O)[C@H](O)[C@@H](O)C(=O)CO	sweet
Gluconic Acid	OC[C@@H](O)[C@@H](O)[C@H](O)[C@@H](O)C(O)=O	sweet
D-Glucose	OC[C@@H](O)[C@@H](O)[C@H](O)[C@@H](O)C=O	sweet
"(2R,3S,4R,5R)-2,3,4,5,6-Pentahydroxyhexanal"	OC[C@@H](O)[C@@H](O)[C@H](O)[C@@H](O)C=O	sweet
D-Mannoheptulose	OC[C@@H](O)[C@@H](O)[C@H](O)[C@H](O)C(=O)CO	sweet
D-Manno-Heptulose	OC[C@@H](O)[C@@H](O)[C@H](O)[C@H](O)C(=O)CO	sweet
D-Mannose	OC[C@@H](O)[C@@H](O)[C@H](O)[C@H](O)C=O	sweet
D-Mannitol	OC[C@@H](O)[C@@H](O)[C@H](O)[C@H](O)CO	"odorless, sweet"
D-(-)-Fructose	OC[C@@H](O)[C@@H](O)[C@H](O)C(=O)CO	sweet
2-Desoxy-D-Glucose	OC[C@@H](O)[C@@H](O)[C@H](O)CC=O	sweet
D-Arabinitol	OC[C@@H](O)[C@@H](O)[C@H](O)CO	sweet
"D-Erythro-2,3-Hexodiulose"	OC[C@@H](O)[C@@H](O)C(=O)C(=O)CO	sweet
"D-Ribo-Hexose, 3-Deoxy-"	OC[C@@H](O)[C@@H](O)C[C@@H](O)C=O	sweet
Galf-Galf	OC[C@@H](O)[C@@H]1O[C@@H](O[C@H](CO)[C@@H]2O[C@H](O)[C@H](O)[C@H]2O)[C@H](O)[C@H]1O	sweet
Gulonic Acid	OC[C@@H](O)[C@H](O)[C@@H](O)[C@@H](O)C(O)=O	sweet
L-Sorbitol	OC[C@@H](O)[C@H](O)[C@@H](O)[C@@H](O)CO	sweet
2152-76-3	OC[C@@H](O)[C@H](O)[C@@H](O)[C@H](O)C=O	sweet
D-Iditol	OC[C@@H](O)[C@H](O)[C@@H](O)[C@H](O)CO	sweet
D-Sorbose	OC[C@@H](O)[C@H](O)[C@@H](O)C(=O)CO	sweet
D-Xylose	OC[C@@H](O)[C@H](O)[C@@H](O)C=O	"woody, smoky, caramel, sweet"
Xylitol	OC[C@@H](O)[C@H](O)[C@@H](O)CO	"odorless, sweet"
D-Galactonic Acid	OC[C@@H](O)[C@H](O)[C@H](O)[C@@H](O)C(O)=O	sweet
D-Galactose	OC[C@@H](O)[C@H](O)[C@H](O)[C@@H](O)C=O	sweet
Galactitol	OC[C@@H](O)[C@H](O)[C@H](O)[C@@H](O)CO	sweet
D-Talitol	OC[C@@H](O)[C@H](O)[C@H](O)[C@H](O)CO	sweet
D-Lyxo-2-Hexosulose	OC[C@@H](O)[C@H](O)[C@H](O)C(=O)C=O	sweet
2-Deoxy-D-Galactose	OC[C@@H](O)[C@H](O)[C@H](O)CC=O	sweet
3-O-Sulfogalactose	OC[C@@H](O)[C@H](O)[C@H](O[S](O)(=O)=O)[C@@H](O)C=O	sweet
Lupinine	OC[C@@H]1CCCN2CCCC[C@H]12	bitter
L-Talose	OC[C@H](O)[C@@H](O)[C@@H](O)[C@@H](O)C=O	sweet
L-Galactose	OC[C@H](O)[C@@H](O)[C@@H](O)[C@H](O)C=O	sweet
5934-56-5	OC[C@H](O)[C@@H](O)[C@H](O)[C@@H](O)C=O	sweet
L-Gulose	OC[C@H](O)[C@@H](O)[C@H](O)[C@H](O)C=O	sweet
D-Sorbitol	OC[C@H](O)[C@@H](O)[C@H](O)[C@H](O)CO	"sweet, caramel, odorless"
Isomaltitol	OC[C@H](O)[C@@H](O)[C@H](O)[C@H](O)CO[C@H]1O[C@H](CO)[C@@H](O)[C@H](O)[C@H]1O	sweet
"Sorbose, L-"	OC[C@H](O)[C@@H](O)[C@H](O)C(=O)CO	sweet
Lactitolum [INN-Latin]	OC[C@H](O)[C@@H](O)[C@H](O[C@@H]1O[C@H](CO)[C@H](O)C(O)[C@H]1O)[C@H](O)CO	sweet
Lactitol	OC[C@H](O)[C@@H](O)[C@H](O[C@@H]1O[C@H](CO)[C@H](O)C(O)[C@H]1O)[C@H](O)CO	sweet
L-Mannose	OC[C@H](O)[C@H](O)[C@@H](O)[C@@H](O)C=O	sweet
L-Mannitol	OC[C@H](O)[C@H](O)[C@@H](O)[C@@H](O)CO	sweet
"(2R,3S,4S,5S)-2,3,4,5,6-Pentahydroxyhexanal"	OC[C@H](O)[C@H](O)[C@H](O)[C@@H](O)C=O	sweet
L-Allose	OC[C@H](O)[C@H](O)[C@H](O)[C@H](O)C=O	sweet
Glc-Man-Hepp	OC[C@H](O)[C@H]1O[C@H](O)[C@@H](O)[C@@H](O)[C@@H]1O	sweet
"Beta-D-Glucopyranose, 6-O-Beta-D-Fructofuranosyl-"	OC[C@H]1O[C@@](CO)(OC[C@H]2O[C@@H](O)[C@H](O)[C@@H](O)[C@@H]2O)[C@@H](O)[C@@H]1O	sweet
Beta-D-Glucose	OC[C@H]1O[C@@H](O)[C@H](O)[C@@H](O)[C@@H]1O	sweet
Lactulose	OC[C@H]1O[C@@H](O[C@@H]2[C@@H](CO)O[C@](O)(CO)[C@H]2O)[C@H](O)[C@@H](O)[C@H]1O	sweet
Lactulose	OC[C@H]1O[C@@H](O[C@@H]2[C@@H](CO)O[C@](O)(CO)[C@H]2O)[C@H](O)[C@@H](O)[C@H]1O	sweet
Beta-D-Lactose	OC[C@H]1O[C@@H](O[C@H]2[C@H](O)[C@@H](O)[C@H](O)O[C@@H]2CO)[C@H](O)[C@@H](O)[C@H]1O	sweet
"3,4-Ebcb"	OC[C@H]1O[C@@H](O[C@H]2[C@H](O)[C@@H](O)[C@H](OCCC3CO3)O[C@@H]2CO)[C@H](O)[C@@H](O)[C@@H]1O	sweet
Mannobiose	OC[C@H]1O[C@@H](O[C@H]2[C@H](O)[C@H](O)[C@H](O)O[C@@H]2CO)[C@@H](O)[C@@H](O)[C@@H]1O	sweet
Beta-Glucogallin	OC[C@H]1O[C@@H](OC(=O)c2cc(O)c(O)c(O)c2)[C@H](O)[C@@H](O)[C@@H]1O	bitter
Amygdalin	OC[C@H]1O[C@@H](OC[C@H]2O[C@@H](O[C@@H](C#N)c3ccccc3)[C@H](O)[C@@H](O)[C@@H]2O)[C@H](O)[C@@H](O)[C@@H]1O	bitter
Gentianose	OC[C@H]1O[C@@H](OC[C@H]2O[C@H](O[C@]3(CO)O[C@H](CO)[C@@H](O)[C@@H]3O)[C@H](O)[C@@H](O)[C@@H]2O)[C@H](O)[C@@H](O)[C@@H]1O	sweet
Prunin	OC[C@H]1O[C@@H](Oc2cc(O)c3C(=O)C[C@H](Oc3c2)c4ccc(O)cc4)[C@H](O)[C@@H](O)[C@@H]1O	bitter
Phlorizin	OC[C@H]1O[C@@H](Oc2cc(O)cc(O)c2C(=O)CCc3ccc(O)cc3)[C@H](O)[C@@H](O)[C@@H]1O	bitter
Daidzin	OC[C@H]1O[C@@H](Oc2ccc3C(=O)C(=COc3c2)c4ccc(O)cc4)[C@H](O)[C@@H](O)[C@@H]1O	bitter
Flavanomarein	OC[C@H]1O[C@@H](Oc2ccc3C(=O)C[C@H](Oc3c2O)c4ccc(O)c(O)c4)[C@H](O)[C@@H](O)[C@@H]1O	sweet-like
Sennoside A	OC[C@H]1O[C@@H](Oc2cccc3[C@@H]([C@@H]4c5cccc(O[C@@H]6O[C@H](CO)[C@@H](O)[C@H](O)[C@H]6O)c5C(=O)c7c(O)cc(cc47)C(O)=O)c8cc(cc(O)c8C(=O)c23)C(O)=O)[C@H](O)[C@@H](O)[C@@H]1O	None
Phenyl Beta-D-Glucopyranoside	OC[C@H]1O[C@@H](Oc2ccccc2)[C@H](O)[C@@H](O)[C@@H]1O	bitter
Helicin	OC[C@H]1O[C@@H](Oc2ccccc2C=O)[C@H](O)[C@@H](O)[C@@H]1O	bitter
Neokestose	OC[C@H]1O[C@](O)(COC[C@H]2OC(O[C@]3(CO)O[C@H](CO)[C@@H](O)[C@@H]3O)[C@H](O)[C@@H](O)[C@@H]2O)[C@@H](O)[C@@H]1O	sweet
Neokestose	OC[C@H]1O[C@](O)(COC[C@H]2OC(O[C@]3(CO)O[C@H](CO)[C@@H](O)[C@@H]3O)[C@H](O)[C@@H](O)[C@@H]2O)[C@@H](O)[C@@H]1O	sweet
Alpha-D-Talopyranose	OC[C@H]1O[C@H](O)[C@@H](O)[C@@H](O)[C@H]1O	sweet
2-O-Talopyranosylmannopyranoside	OC[C@H]1O[C@H](O)[C@@H](O[C@H]2O[C@H](CO)[C@H](O)[C@H](O)[C@@H]2O)[C@@H](O)[C@@H]1O	sweet
Alpha-D-Glucose	OC[C@H]1O[C@H](O)[C@H](O)[C@@H](O)[C@@H]1O	sweet
Alpha-Sophorose	OC[C@H]1O[C@H](O)[C@H](O[C@@H]2O[C@H](CO)[C@@H](O)[C@H](O)[C@H]2O)[C@@H](O)[C@@H]1O	sweet
3-Deoxysucrose	OC[C@H]1O[C@H](O[C@@]2(CO)O[C@H](CO)[C@@H](O)[C@@H]2O)[C@H](O)C[C@@H]1O	sweet
Hex-2-Ulofuranosyl Hexopyranoside	OC[C@H]1O[C@H](O[C@@]2(CO)O[C@H](CO)[C@H](O)[C@H]2O)[C@H](O)[C@@H](O)[C@H]1O	sweet
Globotriose	OC[C@H]1O[C@H](O[C@@H]2[C@H](O)[C@@H](O)[C@@H](O[C@@H]2CO)O[C@H]3[C@H](O)[C@@H](O)[C@H](O)O[C@@H]3CO)[C@H](O)[C@@H](O)[C@H]1O	sweet
3-O-Talopyranosylmannopyranoside	OC[C@H]1O[C@H](O[C@@H]2[C@H](O)[C@@H](O)O[C@H](CO)[C@H]2O)[C@@H](O)[C@@H](O)[C@H]1O	sweet
Sucralose	OC[C@H]1O[C@H](O[C@]2(CCl)O[C@H](CCl)[C@@H](O)[C@@H]2O)[C@H](O)[C@@H](O)[C@H]1Cl	sweet
3-Deoxy-3-Fluorosucrose	OC[C@H]1O[C@H](O[C@]2(CO)O[C@H](CO)[C@@H](O)[C@@H]2O)[C@H](O)[C@@H](F)[C@@H]1O	sweet
Sucrose	OC[C@H]1O[C@H](O[C@]2(CO)O[C@H](CO)[C@@H](O)[C@@H]2O)[C@H](O)[C@@H](O)[C@@H]1O	sweet
1-Kestose	OC[C@H]1O[C@H](O[C@]2(CO[C@]3(CO)O[C@H](CO)[C@@H](O)[C@@H]3O)O[C@H](CO)[C@@H](O)[C@@H]2O)[C@H](O)[C@@H](O)[C@@H]1O	sweet
EINECS 232-684-3	OC[C@H]1O[C@H](O[C@]2(CO[C@]3(CO[C@]4(CO[C@]5(CO[C@]6(CO[C@]7(CO[C@]8(CO[C@]9(CO[C@]%10(CO[C@]%11(CO[C@]%12(CO[C@]%13(CO[C@]%14(CO[C@]%15(CO[C@]%16(CO[C@]%17(CO[C@]%18(CO[C@]%19(CO[C@]%20(CO[C@]%21(CO[C@]%22(CO[C@]%23(CO[C@]%24(CO[C@]%25(CO[C@]%26(CO[C@]%27(CO[C@]%28(CO[C@]%29(CO[C@]%30(CO[C@]%31(CO[C@]%32(CO[C@]%33(CO[C@]%34(CO[C@]%35(CO[C@]%36(CO[C@]%37(CO[C@]%38(CO)O[C@H](CO)[C@@H](O)[C@@H]%38O)O[C@H](CO)[C@@H](O)[C@@H]%37O)O[C@H](CO)[C@@H](O)[C@@H]%36O)O[C@H](CO)[C@@H](O)[C@@H]%35O)O[C@H](CO)[C@@H](O)[C@@H]%34O)O[C@H](CO)[C@@H](O)[C@@H]%33O)O[C@H](CO)[C@@H](O)[C@@H]%32O)O[C@H](CO)[C@@H](O)[C@@H]%31O)O[C@H](CO)[C@@H](O)[C@@H]%30O)O[C@H](CO)[C@@H](O)[C@@H]%29O)O[C@H](CO)[C@@H](O)[C@@H]%28O)O[C@H](CO)[C@@H](O)[C@@H]%27O)O[C@H](CO)[C@@H](O)[C@@H]%26O)O[C@H](CO)[C@@H](O)[C@@H]%25O)O[C@H](CO)[C@@H](O)[C@@H]%24O)O[C@H](CO)[C@@H](O)[C@@H]%23O)O[C@H](CO)[C@@H](O)[C@@H]%22O)O[C@H](CO)[C@@H](O)[C@@H]%21O)O[C@H](CO)[C@@H](O)[C@@H]%20O)O[C@H](CO)[C@@H](O)[C@@H]%19O)O[C@H](CO)[C@@H](O)[C@@H]%18O)O[C@H](CO)[C@@H](O)[C@@H]%17O)O[C@H](CO)[C@@H](O)[C@@H]%16O)O[C@H](CO)[C@@H](O)[C@@H]%15O)O[C@H](CO)[C@@H](O)[C@@H]%14O)O[C@H](CO)[C@@H](O)[C@@H]%13O)O[C@H](CO)[C@@H](O)[C@@H]%12O)O[C@H](CO)[C@@H](O)[C@@H]%11O)O[C@H](CO)[C@@H](O)[C@@H]%10O)O[C@H](CO)[C@@H](O)[C@@H]9O)O[C@H](CO)[C@@H](O)[C@@H]8O)O[C@H](CO)[C@@H](O)[C@@H]7O)O[C@H](CO)[C@@H](O)[C@@H]6O)O[C@H](CO)[C@@H](O)[C@@H]5O)O[C@H](CO)[C@@H](O)[C@@H]4O)O[C@H](CO)[C@@H](O)[C@@H]3O)O[C@H](CO)[C@@H](O)[C@@H]2O)[C@H](O)[C@@H](O)[C@@H]1O	sweet
Melezitose	OC[C@H]1O[C@H](O[C@H]2[C@H](O)[C@@H](CO)O[C@@]2(CO)O[C@H]3O[C@H](CO)[C@@H](O)[C@H](O)[C@H]3O)[C@H](O)[C@@H](O)[C@@H]1O	sweet
58166-27-1	OC[C@H]1O[C@H](OC[C@H]2OC(O)(CO)[C@@H](O)C2O)C(O)[C@@H](O)C1O	sweet
Isomaltose	OC[C@H]1O[C@H](OC[C@H]2OC(O)[C@H](O)[C@@H](O)[C@@H]2O)[C@H](O)[C@@H](O)[C@@H]1O	sweet
Galactinol	OC[C@H]1O[C@H](OC2[C@H](O)[C@H](O)C(O)[C@H](O)[C@H]2O)[C@H](O)[C@@H](O)[C@H]1O	sweet
Gluconolactone	OC[C@H]1OC(=O)[C@H](O)[C@@H](O)[C@@H]1O	odorless
Dextrin	OC[C@H]1OC(O[C@H]2[C@H](O)[C@@H](O)C(O[C@@H]2CO)O[C@H]3[C@H](O)[C@@H](O)[C@@H](O)O[C@@H]3CO)[C@H](O)[C@@H](O)[C@@H]1O	sweet
Difructose Anhydride I	OC[C@H]1OC2(COC3(CO2)O[C@H](CO)[C@@H](O)[C@@H]3O)[C@@H](O)[C@@H]1O	sweet
Ethenol	OC=C	odorless
Formic Acid	OC=O	"pungent, vinegar, formyl"
2-Furanmethanethiol Formate	OC=O.SCc1occc1	"butterscotch, sulfurous, tropica, coffee, horseradish, nutty"
Haloperidol	OC1(CCN(CCCC(=O)c2ccc(F)cc2)CC1)c3ccc(Cl)cc3	bitter
2-Hydroxy-2-Cyclohexen-1-One	OC1=CCCCC1=O	None
Picric Acid	Oc1c(cc(cc1[N+]([O-])=O)[N+]([O-])=O)[N+]([O-])=O	bitter
Levoglucosan	OC1C(O)C2COC(O2)C1O	sweet
Pinocembrin	Oc1cc(O)c2C(=O)C[C@H](Oc2c1)c3ccccc3	bitter
MLS000877024	Oc1cc(O)c2C(=O)CC(Oc2c1)c3ccc(O)c(O)c3	bitter
(-)-Epigallocatechin Gallate	Oc1cc(O)c2C[C@@H](OC(=O)c3cc(O)c(O)c(O)c3)[C@H](Oc2c1)c4cc(O)c(O)c(O)c4	bitter
(-)-Epicatechin Gallate	Oc1cc(O)c2C[C@@H](OC(=O)c3cc(O)c(O)c(O)c3)[C@H](Oc2c1)c4ccc(O)c(O)c4	bitter
Cyanidin	Oc1cc(O)c2cc(O)c([o+]c2c1)c3ccc(O)c(O)c3	bitter
MolMap_000005	Oc1ccc(c(O)c1)C(=O)\C=C\c2ccc(O)c(O)c2	bitter
4-Vinylphenol	Oc1ccc(C=C)cc1	"medical, chemical, almond shell, sweet, phenolic"
4-Hydroxybenzaldehyde	Oc1ccc(C=O)cc1	"woody, sweet, balsam, nutty, almond"
"3,4-Dihydroxybenzaldehyde"	Oc1ccc(C=O)cc1O	"almond, medical, bitter, dry"
Chavicol	Oc1ccc(CC=C)cc1	"phenol, medicine, medicinal, phenolic"
531-95-3	Oc1ccc(cc1)[C@H]2COc3cc(O)ccc3C2	bitter
Naringenin	Oc1ccc(cc1)C2CC(=O)c3c(O)cc(O)cc3O2	bitter
Higenamine	Oc1ccc(CC2NCCc3cc(O)c(O)cc23)cc1	"sweet, creamy, fruity"
Phloretin	Oc1ccc(CCC(=O)c2c(O)cc(O)cc2O)cc1	"odorless, bitter"
Hydroquinone	Oc1ccc(O)cc1	None
"3(2H)-Benzofuranone, 2-[(3,4-Dihydroxyphenyl)Methylene]-6-Hydroxy-"	Oc1ccc2C(=O)C(Oc2c1)=Cc3ccc(O)c(O)c3	bitter
Resorcinol	Oc1cccc(O)c1	"musty, creamy, hawthorn, nutty, phenolic"
5-Hydroxyflavone	Oc1cccc2OC(=CC(=O)c12)c3ccccc3	bitter
Phenol	Oc1ccccc1	"phenol, plastic, rubber, phenolic"
Cyclohexanol	OC1CCCCC1	"phenol, menthol, camphor"
Phenyl Salicylate	Oc1ccccc1C(=O)Oc2ccccc2	"sweet, fruity, balsam, mild"
Benzyl Salicylate	Oc1ccccc1C(=O)OCc2ccccc2	"herbal, oily, sweet, clean, balsam"
Phenethyl Salicylate	Oc1ccccc1C(=O)OCCc2ccccc2	"carnation, balsamic, rose, floral, hyacinth"
Salicylaldehyde	Oc1ccccc1C=O	"cooling, medical, wintergreen, spicy, cinnamon"
Hydroxylupanine	OC1CCN2CC3CC(CN4C3CCCC4=O)C2C1	bitter
"1,4-Dithiane-2,5-Diol"	OC1CSC(O)CS1	"sulfurous, toasted, egg, bread, sulfury, tomato, broth, meaty"
6-Fluoro-6-Deoxy-D-Glucopyranose	OC1O[C@H](CF)[C@@H](O)[C@H](O)[C@H]1O	sweet
685-73-4	OC1OC(C(O)C(O)C1O)C(O)=O	sweet
Cynaropicrin	OCC(=C)C(=O)O[C@H]1CC(=C)[C@@H]2C[C@H](O)C(=C)[C@@H]2[C@H]3OC(=O)C(=C)[C@H]13	bitter
5-Ketofructose	OCC(=O)[C@@H](O)[C@H](O)C(=O)CO	sweet
3-Hydroxypyruvic Acid	OCC(=O)C(O)=O	"sour, cabbage, radish"
2-Hydroxyacetophenone	OCC(=O)c1ccccc1	None
"1,3-Dihydroxyacetone"	OCC(=O)CO	minty
Chloramphenicol	OCC(NC(=O)C(Cl)Cl)C(O)c1ccc(cc1)[N+]([O-])=O	bitter
Isomalt	OCC(O)[C@@H](O)[C@H](O)[C@H](O)CO[C@H]1O[C@H](CO)[C@@H](O)[C@H](O)[C@H]1O	"odorless, sweet"
Hexonic Acid	OCC(O)C(O)C(O)C(O)C(O)=O	sweet
"Heptane-1,2,3,4,5,6,7-Heptol"	OCC(O)C(O)C(O)C(O)C(O)CO	sweet
Aldohexose	OCC(O)C(O)C(O)C(O)C=O	sweet
1990-29-0	OCC(O)C(O)C(O)C(O)C=O	sweet
2595-98-4	OCC(O)C(O)C(O)C(O)C=O	sweet
"Pentane-1,2,3,4,5-Pentol"	OCC(O)C(O)C(O)CO	sweet
"Butane-1,2,3,4-Tetrol"	OCC(O)C(O)CO	sweet
"Hexane-1,2,5,6-Tetrol"	OCC(O)CCC(O)CO	sweet
Glycerol	OCC(O)CO	"odorless, sweet"
"D-Mannitol, Mixt. With 1,2,3-Propanetriol"	OCC(O)CO.OC[C@@H](O)[C@@H](O)[C@H](O)[C@H](O)CO	sweet
Glyceryl Tribenzoate	OCC(O)COC(=O)c1ccccc1.[O-]C(=O)c2ccccc2.[O-]C(=O)c3ccccc3	"balsamic, benzophenone, plastic, clean, green"
2-Deoxy-D-Glucitol	OCC[C@@H](O)[C@H](O)[C@H](O)CO	sweet-like
Allyl Alcohol	OCC=C	"mustard, pungent"
87-81-0	OCC1(O)OC[C@@H](O)[C@H](O)[C@@H]1O	sweet
Laevuflex	OCC1(O)OCC(O)C(O)C1O	sweet
4-Hydroxybenzyl Alcohol	OCc1ccc(O)cc1	"coconut, bitter, sweet, fruity, almond"
Benzyl Alcohol	OCc1ccccc1	"berry, balsamic, rose, floral, walnut, sweet, cherry, phenolic, flower, grapefruit"
Cyclohexylmethanol	OCC1CCCCC1	None
Tetrahydrofurfuryl Alcohol	OCC1CCCO1	"caramel, warm, cauliflower, vegetable, oily, faint"
Phenylacetaldehyde Glyceryl Acetal	OCC1COC(Cc2ccccc2)O1	None
Aloin B	OCC1OC(C(O)C(O)C1O)[C@H]2c3cccc(O)c3C(=O)c4c(O)cc(CO)cc24	bitter
Hexopyranose	OCC1OC(O)C(O)C(O)C1O	sweet
.Alpha.-Lactose Monohydrate	OCC1OC(O)C(O)C(O)C1OC2OC(O)C(O)C(O)C2CO	sweet
Cellobiose	OCC1OC(OC2C(O)C(O)C(O)OC2CO)C(O)C(O)C1O	sweet
Maltose	OCC1OC(OC2C(O)C(O)C(O)OC2CO)C(O)C(O)C1O	sweet
Cellobiose	OCC1OC(OC2C(O)C(O)C(O)OC2CO)C(O)C(O)C1O	sweet
Alpha-Lactose	OCC1OC(OC2C(O)C(O)C(O)OC2CO)C(O)C(O)C1O	sweet
Maltotriose	OCC1OC(OC2C(O)C(O)C(OC2CO)OC3C(O)C(O)C(O)OC3CO)C(O)C(O)C1O	sweet
D-(+)-Trehalose	OCC1OC(OC2OC(CO)C(O)C(O)C2O)C(O)C(O)C1O	sweet
Trehalose	OCC1OC(OC2OC(CO)C(O)C(O)C2O)C(O)C(O)C1O	sweet
Melibiose	OCC1OC(OCC2OC(O)C(O)C(O)C2O)C(O)C(O)C1O	sweet
Melibiose	OCC1OC(OCC2OC(O)C(O)C(O)C2O)C(O)C(O)C1O	sweet
D-Raffinose	OCC1OC(OCC2OC(OC3(CO)OC(CO)C(O)C3O)C(O)C(O)C2O)C(O)C(O)C1O	sweet
"2,3-Epoxypropyl O-Galactopyranosyl(1-6)Galactopyranoside"	OCC1OC(OCC2OC(OCC3CO3)C(O)C(O)C2O)C(O)C(O)C1O	sweet
Gamma-Dextrin	OCC1OC2OC3C(O)C(O)C(OC3CO)OC4C(O)C(O)C(OC4CO)OC5C(O)C(O)C(OC5CO)OC6C(O)C(O)C(OC6CO)OC7C(O)C(O)C(OC7CO)OC8C(O)C(O)C(OC8CO)OC9C(O)C(O)C(OC9CO)OC1C(O)C2O	odorless
Furfuryl Alcohol	OCc1occc1	"coffee, alcoholic, bitter, musty, chemical, caramel, sweet, burnt, bread"
"1,2,4-Butanetriol"	OCCC(O)CO	sweet-like
2-(4-Hydroxyphenyl)Ethanol	OCCc1ccc(O)cc1	"floral, sweet, fruity, mild"
2-Phenylethanol	OCCc1ccccc1	"lilac, rose, rose water, honey, rose flower, floral, spice, bitter, rose dried"
"1,2,5-Pentanetriol"	OCCCC(O)CO	sweet
3-Phenylpropan-1-Ol	OCCCc1ccccc1	"mignonette, cinnamyl, fruit, sweet, anise, balsam, hyacinth, spicy, cinnamon"
"1,2,6-Hexanetriol"	OCCCCC(O)CO	sweet
5-Hexen-1-Ol	OCCCCC=C	green
Benzenepentanol	OCCCCCc1ccccc1	"lemon, carnation, rose, floral, verbena"
10-Undecen-1-Ol	OCCCCCCCCCC=C	"citrus, ozone, waxy, fresh, floral, clean"
"1,5-Pentanediol"	OCCCCCO	bitter
Chlorbetamide	OCCN(Cc1ccc(Cl)cc1Cl)C(=O)C(Cl)Cl	bitter
Dipyridamole	OCCN(CCO)c1nc(N2CCCCC2)c3nc(nc(N4CCCCC4)c3n1)N(CCO)CCO	bitter
Hydrogen Peroxide	OO	bitter
Hydrogen Sulfide	S	"egg, rotten"
Diphenyl Disulfide	S(Sc1ccccc1)c2ccccc2	"earthy, burnt, sulfurous"
2-Thienyl Disulfide	S(Sc1sccc1)c2sccc2	"rubbery, earthy, mushroom"
Benzyl Isothiocyanate	S=C=NCc1ccccc1	"watercress, mild, oily, horseradish, dusty, medicinal"
Phenethyl Isothiocyanate	S=C=NCCc1ccccc1	"horseradish, watercress, bitter, green, gooseberry"
Thiophene	s1cccc1	"garlic, alliaceous"
Thiazole	s1ccnc1	"nutty, pyridine, meaty"
Benzothiazole	s1cnc2ccccc12	"rubber, vegetable, gasoline, sulfury, meat, rubbery, coffee, nutty, cooked"
2-Naphthalenethiol	Sc1ccc2ccccc2c1	"sulfurous, roasted, rubbery, woody, creamy, artichoke, meaty"
Cyclopentanethiol	SC1CCCC1	"citrus, wine_like, garlic, onion, vegetable, egg, alliaceous, fatty, floral, earthy, woody, horseradish, fruity, celery, herbaceous, nutty, meaty, spicy, green"
Benzenethiol	Sc1ccccc1	"garlic, penetrating, repulsive"
Thiophene-3-Thiol	Sc1cscc1	"garlic, cooked, meat, cooked meat"
Allyl Mercaptan	SCC=C	"sulfurous, roasted, garlic, onion, alliaceous"
Mercaptoacetaldehyde	SCC=O	cabbage
Benzyl Mercaptan	SCc1ccccc1	"mint, sulfurous, garlic, onion, sharp, coffee, horseradish, alliaceous"
2-Mercaptomethylpyrazine	SCc1cnccn1	"roasted in sugar syrup, meaty"
Furfuryl Mercaptan	SCc1occc1	"roast, chocolate, burnt, sulfurous, roasted, smoky, sulfury, fishy, oily, fatty, coffee"
2-Thiophenemethanethiol	SCc1sccc1	"sulfur, roast, coffee, fishy"
2-Phenylethanethiol	SCCc1ccccc1	rubber
Pyrazineethanethiol	SCCc1cnccn1	"cabbage, sulfurous, meaty"
"1,8-Octanedithiol"	SCCCCCCCCS	"earthy, mushroom, sulfurous, meaty"
"1,6-Hexanedithiol"	SCCCCCCS	"fatty, burnt, meaty"
"1,3-Propanedithiol"	SCCCS	"sulfurous, meaty"
"1,2-Ethanedithiol"	SCCS	sulfury
Methanedithiol	SCS	pungent
